##########################################################################################
##                                                 # ###   # # # #  #    #     # ##### # #
#  ## ## ## # # # ## # # # # ## ## # # ## ## ## ##    # ##   #   # ### # # # ##   ###    #
##   #   # #  # #  ##   #  #  #   # # # # # #   ## ##     ##  # #  ## #   #  # # # # # # #
#  # # #    # # # #  # # # # #  ##       #  # #   #   # # #  ##   #    ##  #       #  ## #
##  # # # #  #  #   #     #   #  # ## ##   # #  ##  #  # # #   ##  ## # ## # # ###   #   #
#  ##   #  ## #  # #  # # ###  ### #  #  #    # #  ## ## # # ## ##          #  #   ##  # #
## #  ## # #    #  # #  #    # #   ##  #  ## # #  ##              # # # ###  #  ## # ##  #
#    # # #  ### # #  ###  ## # ## #   ## #  #   ##   # # ## # # #   ## #    #  ### #   # #
## #      ###  # # #    ## ## #  #  # #    # # #   ### #  # #  #  #    # ## ##  #  # # # #
#   ## # #   #   # ### #    #  #   #  ## # #    # ##    # # # # # ## #  ###    ### # # # #
## # # #   # # # #    #  # #  #  ## #  # ### ##  #   # #  # # # ##    #  #  # # #  # # # #
#     # ## ##  #   ### #  # #  ##     ##     ###  # #  # # #  #  # # ## ###  #    ## # # #
## # #    #  ## # #  #  #   # # # # # #  ###  # ##   ##     #   ###  #   #  # # #    # # #
## ## # ### # # # ## # # ## # # ##  #  #    #   #  # #  ## #  ####  ## #  # #    # # # # #
#                                 ##  #  ##  # # # ## ##  # # # # ##    #  #  #### ##  # #
## # # # # # ## # ## # # # # # # #  #  # # ## #   #   ### #  ## # # # ##  #  #       #   #
# # # # #   #    # # ## # ## #  # #   #     #  # #  #  #   # #    #  #  # # #### ## ## # #
# # #    ### ## #   # #     #  #   ##  # ##   #  # # # # #    ## # #   ##  # # ##   #   ##
# # ## ### # # # ## # ## ### # # ##   #  # ##  #  #  # #  # ##   #   ##   #       #  # # #
#                                  ##  #     ##  ## #    # # # #   #   # #  # # # ###    #
# # # ## ## # # ## # ## # # # ## ## # #  # ##### #    ## #    #  # # ### # #   #    # ## #
# ### # # # ###  # #   #  # #  #  #    #  #  ##   # # # #  ###  # # ##    ### # # # # #  #
#    #         # # ## ### #  ##  # ## #  # #   # ###    # #   #       # #  #     # ##  # #
# # # ## ## ## # #  #  #   #   # #    ## # # ### ## ## #   # #  # # #  ###  # # #     ## #
# #     #     ##  #  ## # #  ##   # #  #                # #    #   # ## #  #  #  ## # #  #
#  ## ## ### ## ## # #     #   # ###  ### # # ## # # ##     # ### #      #  # # #    # # #
# #  #     # #   # ## ## #  ##  # ###  #  # # #   #    # ##  # # ## # ## # ### ### #   # #
# # ## # ## ### #   #     #  # ##  ## #  #  # # #  ## #  #  ##       #  # # #  ### # ### #
#     #   #  #  # ## ## #  #  ## #     ####  #  ###   ### #    ## ###  #    # # # #     ##
# # # # # ## # ##     #  ## # #    ## #  #  ###    ###  #   # #  #  # # # #   #    # ## ##
# ## #  #         # #  #    # # # #     # ####  # #   #   #  # #  # #    ####   ##  # #  #
#    ## # ## # # ##  #  # # # ## #  # #     #  #   ##   ### ## # #    ### #   # ### #  # #
# # #   #   #  #   #  # # # ##     #   # # # # ## ## # #           # #  # # #  # # # # # #
#  ## # # ##  ### ### ##   # # # ## # # # ## #  # #    ### # ## ## #   #   ## #      #  ##
# ## #  #   ## # # # # ### #  # ##            # # # # #     # #   #  ##  ##    # ## ###  #
#     # # ##       # #    ### # # ### ## ## # #### #  # # # #   #  ##   # # # #    ###  ##
# ### # # # # ## #    # ## #            # #  #  ##  #  # # # ## # # ## #   #   # ## #  # #
#    #  #      #  ### #  #  ## # # ## #    ####    #  #      ##  #   # ## # ## #  #  #   #
# # # #  ## ##  # #  #  # #   # # #   ## # # # # #  ## #### #   #  # #  # #    ##  # # # #
# ##    ##  #  # #  # # #   ##  #  ##   # #  #  # #    #  #  ##   # #  #  # ##  ##    #  #
#   # #   #  #    #   #  # # ##   # # ### # # #   #### # #  #   ##   #  #  #   #   # # # #
## # ## ###### # # # #  #      ##     #        ##    # # ## # # # ## # # # ### ## # ## # #
#    #    #    # #    # # ## ##  # ##   # # # #### #         #                           #
## #  # ##  ## # # # #      #  #  #   #  # ### ## # ## # # # # # ### # ## # # # # # ## ###
#  # #  # # #  ## #   ## # #  ###  ##  # #  #       # ##  #  ###   # #  #  ##  #  ##     #
##  ###   ## #  #  # ##   ###  #  #   # ## ### ### #     ###    ##  #  # ##   # ##   # # #
## # ## ##     # # # # # # ## ## # ##       ###    ### #  #  ##  # ###    # # #  ####   ##
#        ### #                        # ###  #  ##    #  # #   ## # # # ## #  ##    ## # #
## # ## #  #  ## ## # # # # # # ### ## ##   #  #  # ## # #   ## #   #       #   # #      #
# # #     ### #  # # ## # # #  #         ### ## #         ## ##   ## # ## ### ## #  ## # #
#     # # ## ###   # # ##  #  # # #######         # # # ##      #    ## # #  # #  #  # # #
## ## # ##    ### #      ## ##   ##     # ## # ## #  #   # # # #  ### #  #  #   #  ##   ##
#  ###    # ## # # # #### # # # ## ## ## ## # # # # # # # #   # ##  # # # # # # # #### # #
##  # # ##                                         #       # #   # #  # #    #     ### # #
#  ## # # # ### ## ## # # # # # # ### # # # # # # # ##### #   # #   #   ## #   # #  #    #
# #    #  #    ##    #  # ###  #  #    # #  #  #         # # ##  ##  # # #  # ##  #  # ###
## ## # # ####   # #  # #    #### ## #   ## # ## ## # # #       #  # # #  # # #  #  ##   #
#              #### #  # # # # ###  #  ##  ###    # #  # # # # #  ## # # # # # #  # #  # #
# # # # # ## #   #  ## # # #    #  # # #  # ## ###   # # ##   # #        #       #  # # ##
# # # # #   #  ####  ##  #  # ##  #  ## # #   #   # # #    # ## # ## # #  ## # #  # #   ##
#  #  ##  ## ##  # #    #  ####  #  # # #   ##  # ##  ## ##       ## # # # ## ## ## # #  #
# # ##   # #   #   # ### ## #  #  #       ###  # #  #      ## # #   ## #         #  #  # #
# # # ###   ##  # #  #   #  # #  ### # # #   #    #   ### #   # # # # #  ## ## ## # # # ##
#   #   # ## # #    # ## # ## # # # ## # # # # # # # ##    # # # ####   #  #  # #   # #  #
## ## ##         ##                     #   #   #  ##  ###  #     #  # #  #  #   ##     ##
#        # # # #  # # # ## ## # ## # ## ## # # ## # ## # # # ## ## # ## # # # # ## ## #  #
# # # ##  # ### #  # ### # ## ##  #  #                                              #  # #
##   # # ##  #  # ##  #   #  # ##  # ## #### # ## # # # ## ## # ## ## # # ### ### ## ## ##
# ## #   # #  #  #   #  ##  #    #  #  #   # #  # #  ###  ### #  #  # # # #  #  #        #
# # # #### # ## # ## ## ## # ## # # ## ## # # ## # ## # # ## # ## ## # # # # ## ###### ###
#                                                                                        #
##########################################################################################
RRRRRRRRRRRRRRRRRRRRRRRRRRRRRRRRRRRRRRRRRRRRRRRRRRRRRRRRRRRRRRRRRRRRRRRRRRRRRRRRRRRRROOLLLLLOOLLLLLLLLLLLLLLLLLLLLLLLLLLLLLLLLLLLLLLLLLLOOLLLLLLLLLLLLLLLLLLLLOLLLULLLLLLLLULLLLLLOOLOOOOOORRRRRRRRRRRRROOLLLOORRRRRRRRRRRRRRRRRRRRRRRRRRRRRRRRRRRRRROOOORRRRRRROOOOOOORRRRUUUUUUUUUUUUUUUUUURRRRROORRRRRRRUUURRRRRRRROOOOOOOORRURUUUUUUUUUURROOOOOOOROOOOOOOOOOOOOOOLLLLLLLLLLLLLLLLLLLLLLLOOOOOOOOOOLLLLOOOOOOOLLLLOLLLLLLLLLLLLLLLOOOOOOOOOOOOOOOOOOOOOLLLUUUUUUUUUUUUUUUUUUUUUUUUUUUUUUUUUUUUUUUUUUUULLLLLLLLLLLLLLLLLLLLLLLOOOOOOOOOOLLLLLOOOOOOOOOLLUUUUUUUUUUUUUUUUUUULLLLLOOOOOOOLOOOOOOOOOOOOOOOOOOOOORRRRRRRRRRRRRRRRRRRRRRRRRRRRROOOOOLLLLLLLLLLLLLLLLLLLLLLLLLLLLOOOOOOOOOOOOOORRRRRRRRRRRRRRRRRRRRRRRRRRRRRRRRRRRRRRRRRRRRRRRRURRRUUUUURRRRRRRRRRRRURROORRRRRRRRUUUURRROOOOOORRRRUUUUUUULUURRROOOOORRUUUUUUUURROOOOOOOOOOOOOOO