####################
#    #   # #    #  #
## #   ### ## ## # #
# #  #             #
#   #  # # # # ## ##
## #  #   #  # #  ##
# # # # ####  ## # #
# #  #    # # #    #
#  #  # #    #  ## #
##  # #  # #### # ##
# #    #  #  #  #  #
#   # ### # # ## # #
# # #  #           #
#  #  # #### ### # #
# # #       #   ## #
#   # # # #   #    #
####################
OOOORRORRUUUURRRRRRURRORRURRROOOLLLLLLLLLOOLOLOOOOROORRRRRRRRRROO