##################################################
### #  #   ###   # ###  # #         #       ###  #
##   # # #  #  ##   #  #  ## # # # # # ### # # # #
# ## #  # # ## # # # # # #  #  ##      #     #   #
#      #                   # #  # # ## ### # ### #
# # ## # #### # ## ## ### #    # # #  #     #    #
#  #   #     # #     #    ## #       ## # ## # # #
# #### # ### #  ## #  # #   #  ## # #    ##   #  #
#  # # # #    #   # ## #  ## # # ### ## ##  # ## #
# ##    #  # # # #      #    #    #       # #  # #
# # ## ## #        # # #  ###  ## # # # ##  # #  #
#    #   # ## # # ### # # #  #   ### ## # # #  # #
# ## # ##   #  #   #  # #  #   # ##       # # #  #
#   ## ### #  # # ## #    ####  #  # ## #   # ## #
# ##    ##  ##       # ##  #   # #  # # # ##   # #
#  # ##    # # ## ## ##   ## #     #     # # ##  #
# # #   ##    ##    #   #   #  ## # # # ##   ### #
#   # #  # # #  # # ####  # ## #     #    ##  #  #
# ##  # #   # #   ##    #  #    # # #  ## ## ### #
#   ##  ###    ##  ## #   #### #   # #   #    ## #
# ### #    ## # # # ## ##  # #  ##   ## #  # #   #
# #     ##   #          # ##   #  ##  ## ##   ## #
#  ## # ## ##### ## ## #  #  #   # # #   # # #   #
# #  #    #  #  ##  #   # # #  ##   ## # #    ## #
#   ## # #  # #   # ## #   ###    ##  #    # ### #
# # # ## ## # # ## # # ## # #  # # # # ## #  ##  #
# ##  #                 # # ## ##  # #   ###   # #
#   # # # ## # ## ## ###         # # # #  #  # # #
# ##  # # # #  ###  #  # ######### # #  ## # # # #
#   #  # #   #  # # # # #              #      #  #
# ### ## ## # ###         ## ## ## # #  # # #  # #
#                 ## # # #  #   # #  ##  # # # # #
# # ## # # ## # # ### # ## # ###  ##   # #     # #
# #   # #   #  #   #             # # ## #  # # # #
##  # #  # # #  ## # # # # # # ##        ####  # #
# ##   #  #   ##  #   # ## # #   # # ## #  ### # #
# # ## # #  #   # ## #    #### ## #   ## #  #  # #
# # # ##  ##  ##     ## #  #    #  # # #  #  # # #
#        #  #   # ##     #  # #  #       #  ## # #
# ### # # # ## # # ##### # ###  #  # ###  #      #
# # # #                   # ### ##  #    # ## # ##
# #  ## # # # # # ## ## #    #    ## # #     #   #
# # ##  #  ## #  # ##   # # # # ####  # # # # ## #
#     #  ##  #  ##    # #  #    # # # # # # #   ##
# ## #  ##  # #   ###  #  # # #          #    # ##
# # # ##   ## ## #    # # #  #  ## # # ## # ##   #
# # # #  # #    # # #    #  ## #   # #      # ## #
#     # # #  ##    #  # ###    # ##   # # #     ##
# # #       ##  # #  #   #  ## #  ## #  ##  # #  #
#  #  #### #  # #  # # # ###  #  #   ##  ##  ## ##
# # #    # # ##  #  #   #  # # # # #   ##   #    #
# #  ## #  #   # # ## ## #       ## # ##  ## ## ##
# # ## # ##  # ##  # # #   ## # #       #     # ##
#           ###   #      #   #   # # # #  # # #  #
##################################################
OOOOOOOOOOOOOOORRRRRRUURRRRRRRRRRRRRRRRROOLLLLOOOOORRRRRRRRRRUUUURUUUUUUURRRRRRRUURRRRROOOOOLLLOOOLLLLOOOOOOOOOLLLLLLLLLLLULLLLLLLLULLLLLLLLLLLLLLLLOOOOOOOOOOOOOOOOOOOOOOOOOOORRRRRUUUUUUUUUURUUUUUUUUURUUURRRRRRRRRRRRRROOOOOLLLLLOOOOOOOOOOOLLLLLOOOOLLLLOORRRRRRRRRRRRRRRRRUUUUUUUUUUUUUUUUUUUUUUURRRRROOOOOOOOOOOOOOOOOOOOOOOOOORRRRUURRRROORRRRUUUULLLUUUUUUURRURROOOOOORRUUUUUUULUUUUUUUUUUUUUUURURUUUUUUUUURROOOOOOOOOOOOOOOOOOOOOOOOOOOOOOOOOOOOOO