############################################################
#    # #    ##   # #  #  # #  #   # #  # #  # # #    #     #
## #    # ##  # ##  # # #   #   ##    #   #       ##  # ## #
# ### ##  # #   #  #  #  # # ##    # # # #  # ## #  #  # # #
#  ##  # #    ## #   # #     #  # # #  #  ##    ###  #   # #
##   # #  # #  #  ## # # # #   #     #   ## # #  # # # # # #
#  # # # # ## ## # # # # # # ## ## ## ##       ##     ## # #
# #                     #  #  # #  #   ###### #  ### #   # #
### ## ## # # ### ## # # # # #   ## # #         ## # # ##  #
#     #  ###  #  #   ### # #   #  #    ## ### # #      # # #
# # #### ##  # # # #       # # ### ## #  #  # # # # # ##   #
##    #    ##  #  #  # # # # ##  #  #   # #    # ##  ## ## #
# # ### ### ## # # ##  #  #     # #   # #  ## #    # #     #
#                    ## #### ## # # #  #  # # ## # #  ## # #
# # # # # ### # ## #      ##   ##  #  ## ## #     # # # #  #
#  # #  # #  #    #  # # #   ##   # #         # # #     ## #
# ## ## #   #  #### # # # ## # ##     # # # # # # # # ##   #
# #   # # #  # #           #      # # # # ##   #  # #  # # #
# ## #   ## # # # # ## ## # ## ## # # # #  # #  ## #  # ## #
##   # # # #      #   ###   #  #   # #  # ###  ##   #   #  #
## # ## #  ## ## #  #  # # # ##  #    ##   ### # ##   #  # #
# ##    ##   #  #  # ##    #  # # # # #  #  #     # # # #  #
# # ## # # ## # # #  ### #   # #  #  #  #  ### # # # #   # #
#                # #  # #  #    #  #  # ##  ## # #   ## ## #
## # # # # # # #     #   #  # ##  # ####   #    #  #    #  #
#  # #  #  #  # # ## # # # #  ###     #  #  ## # ##  ##  # #
##  #  # # # ## ##   # # #  ## #  ####  ####  #  # # #  #  #
#  # ##  #  #      # # # # #    #    # # #   # #   ## #  # #
##      #  # # ### # # # #   #### ### ##   #     #      ## #
#  # ##  #   # #  #  # # # #            # #  ## # # # # #  #
## ##  # # #  ## # # # # # ### # # # ### #  #  #    # #  # #
#     # # # # #      # # #    ##  # #    # # #  # #  #  ## #
## # #       # # # # # # # ###  ##   # ####   #  #### # #  #
#   #  # # ##  ## #  # # #    #   # #    #  ### # #   # ## #
## #  ##  # # #    # # # # # # # #   ## #  ##      ##    # #
#    #  ##     # #   # # #  #  # ## ### # #  # # # # ## #  #
## ## #   ## ##   ## # # # ###       #  #   # # #        # #
#       # #  # # #     # #  # ### ### # # ### #   ## ## #  #
## ## ## # # #  # # # #   #                    # ## #    # #
#   ## #     # ##  #   # #  # # ## ## ## # # #  #     # #  #
# #  #  # # ## # #  # ## ##  ## # #   ## ## #  #  ## ## ## #
# ##   ###  #  # # # ##    ##  #   # #       ## ## ##    # #
##   #  # # ## #   #   # ##  #  ##  #  # # #    #     # #  #
# # ###          #####    # # # ## # ### #  # ## # # #   # #
# ## # #########   # # # #                ##      # # # ## #
#                #   # #   # # ## # # ## #### # ##         #
############################################################
RRRRRRRRRRRRRRROOLLLLLLLLLOLOLLOLOLOOOOOOOOOOOOOOOORRRRRRRRRRRRRRURRRRUUUUUUUUUUUUURROOOOOOOOOOOOORRUUUUUUUUUUUUUUUUUUUUURRORRRRRRRRRRRRRROOOOOOLLLLLLLLLLLLLOLOOOOOOOOOOOOOOOOOOLOOLLLLLLOOROOLLLLLLLLLLLLLLLLLOOOOOORRRRRRRRRRRRRRRRRUUURRRRRROOOOOORRUUUUUUUUUUUUURRRRRORRRRORRRRRRRROOOOOOOOOOOOORRRRORRRURURURRUUULLUULLLUURUURUUUUUURRUUUUUUUUUUUUUUUUUUUUUUUUUURRROOOOOOOOOOOOOOOOOOOOOOOOOOOOOOOOOOOOOOOOOOOO