################################################################################
# # # # #              ### ## # # # ## # # ## # #           #  ### #  # # ## # #
#         # # # ######  #                         # # ## ##   # #   #        # #
# # # # #  # # #       ## ##### # # ## # # # # # #  #   #   ##  # ## ## # ## # #
#  # # #  #      # ## #        # #   ##  # #  #  ## # # # #  # ## #    #   # # #
## #    # # # ##  #   # # ## #    ##   # ##  #  #  #   # #  #      ## # # #  # #
# #  ##   # ###  # # # #   #  # ## # ## # ##  # # #  #    # ## ## #     #  # # #
# # #  ## #    #   # #  # #  ## #   #   #  # # ##  # # # #     ## # # # # #  # #
#  # #    # # # ### #  # # # # # # # # ## # ## # #  #   # # # #    #  # #  # # #
# #   # # # # #   #   #                            #####     ## # ## #  # #  # #
# ###  #  # ##  #### # ## # ## # ## # # # ### ### # #    # ##   ##   ## #  # # #
#     ### #  ## # #     # ##  #  # #   #  #  #  #   ## # # ####  # #  # # #  # #
# # #  #   #        ## # # # ####  # #  ##  ###   ##  ### # # # # ## ## #  # # #
## # # ## #  # #### # ##      # # # # ## # # # ##    # #  #     #    #  # #  # #
#          ## #       # # # #                     ###    #  # #  # # ## #  # # #
# # #### ##    ## # ##    ##  # ## # # # # ## # #    # #  #  ## ###   # # ## # #
#  #   #   # ##  #    # ## ## # ###   #  # # #   # ## ## ####    # # #  # #  # #
# #  #   ##    #  # # # #   # ## # # ## #     # #   #     # ### #    ## # ## # #
## ## ##   ## # #   #  #  #        # # # # # ##  # ## # #     # ## #  # #  # # #
#      # #    #   #  # # # ## # # #      # #   #  #    #  ###     ## #  # ## # #
# ## #   ## ##  ##  # # #     #  # ## ###   # ## #  # #  ## ### ##    # # #  # #
##  #  #   ## ##  #   #   ## #  #  #     # ##   # ##  # #         ## #  #  # # #
#  # # # ##   # # # #  ##  #  # # # ## #  #  # ## #  #  # ## ## ####  # # #  # #
# ##  #     ##       ## # # ##        ## ###  ##   # # #    #     #  #  #  # # #
#    # # # # # # ## # #   #   # # ####  # #  ##  ## # #  ##  ## #  # ## # #  # #
## #      #  #  # #   ###   #  # ##    #   #   # #    # ## ## # # ##  # # ## # #
#   # ## # # ## #   ##  # #####     ### # # # #    ##  #         #   ## #  # # #
# ##   # #     # ##  ##     # # ###   #        # #  # # ## ## # ## # #  # #  # #
# # # #   ## ##   # #  ## ###  #  # ## # # ###  #  ###  ### # #   ##  # # ## # #
##   # # # # # ##    #    #   ## #  #   # #    # #  # #  #  ##  ###  #  #  # # #
# ## #         # ## # ###  ##     #   ##  # ##   # ## # # #   #    #  # # ## # #
# #    # #### #  #      # #  # # # # #  #  #  # #       #  ## # ## # ## # #  # #
#  ## #     ## #  # ### # # # ## # # ## # ## ## ## # # # #        #  #  # ## # #
# ## # # ##     #     # #   #                       # #    # ## ## #  # #  # # #
#          # ###  # ## #  ##  ### ## # # # # # # # #   # #  # # #  # #  # #  # #
# ## ### #  ## ###  #   #   # #    #  #  # # #  ##   ## # ##     # #  # #  # # #
##      ## #      # ## ## # #  ## #  ###  #   ##   #    #    ## #    #  # #  # #
#  # ## # # # # # #    #   #  # # # ###  # # #  ##  ## #  # # #  ### ## #  # # #
###  # #     ###  # ## ## ###   # ## #  ##    #    # # ## # #   #  #  # # #  # #
#  #     # #  # #    #  #  #  # #     ##   # # # #    # #### ##   #  ## #  # # #
##   # #  #  ## ### ####  # # ##  ## #  ## ##   #  # #    #  ## # # ##  # #  # #
# ## ## ## ##     #  #  #   #  # #### #   #  ##  #  ### ## #     ## # # #  # # #
#          # # ##   # #   ##  # # ##    ## # # # # # #      # # #   #   # #  # #
# # # # # #   #  ##   ###   #        # #              # ######   ## # # #  # # #
# # ##   #  # # #   ##  # # # # # ##  # # # # # ## ##       # # ###  #  # #  # #
#  #  ##   # #   ##   #    ##  #   # #   #  #  #   # ## # ##    ##  # # # ## # #
# #  #   ##   # # # ##  # ##  # ## # # # # # ## ##   #  # # # #   # # # #  # # #
# ##  ## # # #      # ##    # #  # ##  ## #        #  #  #  ### ### #   # #  # #
#  # # ##      ## #     # ##    # #  #  #   # # ## # #  ###     #    ## # ## # #
# ##     # ## #   # ## #   ## ###  #  #  ###   # #  # # ##  ###  ## # # #  # # #
#    # ##  # # # #  # # # # #    #   ## #   # #    #   #  #    ## # #   # #  # #
# # #  # ###    # #   # #     ## # ##    ## ## ###   ## # # # #   # # # # ## # #
# #  ##  #   ##     ##    ###   #  # ## # #  # #   # #       #  #    #  #  # # #
# ### ##  ###  # ##   # ##  # #  #   #  #   #  # #  ### # # # ##  # ### # #  # #
#       #   # # # # ## # # # # ## ## ## # ## #  #  #### # #   #  #   #  #  # # #
# # # # ###                                    ### ### # #  ## ## # # # # #  # #
# #### #  # # # # # ## ## # # ## # # # ## ## #  #   #  #  #       #   # #  # # #
#   #  # #   #  # # #   # #  #   ##   #  # ##  ### #  #  # # # ## # # # # #  # #
# #   ##  # ###  #  # # # # #  ##   ## #    ##  ## # ## #     # # #  #  # ## # #
# # #    # ###  #  # # #  #  ##  # # # ## ## # #         ### #    # ### #  # # #
# #  # ##   #  ###     # # #   # ##             # # ## #   # # ##    #  # ## # #
#  #  # # ## #  #  # ##    # ##     # ## # ## #  #    #  ##   #  # #### # #  # #
# ### #      ### #####  # #    #### #  # ##  ## # # #  #   # ## ##   #  #  # # #
#  # # # ###   #   #   # ## # #      ##   ##    #   # #  ## #      #  #   ## # #
# #    # # # ## ##  ##     # # # ## #  # # # ##  ##  # #    # ## ## ##  ##   # #
# # # #  #  #      # ## # #     #     #  #   ## #  # #   # #  #      # ##  # # #
#    ### # # # # #    # #  # ##   # ## ##  ##    #  # ## ## #  ## # # #   ## # #
# # ###  #     ##  # ###  #   ## #       ###  ## ##    #     ##    #  # # #  # #
# ## # # # # ## # # # # ## # #    # ## ##    #     # #   ## ## # #  #  # # # # #
#          ###   #  #       # # ##   # # # # ## # #   ##   #      #   ## # # # #
## # # ###     #   #  # # # #  #  # # #   # #  ### # #   ## ### # # ##     # # #
#  # ### # ## #  # # ###   #  # #       # #  #  #   #  #      #  #    # ##     #
##  #        # ####   # # # #     ## ##  # #  #  # ## #  # # ### # # #  # # # ##
## #  ## # #     #  # #  #   ## # #  # ##    ### #   # #  ### # ##  #  #     # #
#  # # ###  # # ### #   # # #  # # # #  # ##  #    ##    # ##     ## ## # ##   #
##  #      # # # #   # #     # #   #   # #  #  ## #  ###      ## #   #    #  # #
# ## # # #     #  # # # # ## #  # #  #     # #     #     ## ####   # # ##  # # #
# #     ### # ## #    # ##     ## ## ## ## #  ## # # # #   #  # ### ###   #  # #
#  ####### ##     # ##    # ##         #  #  ###  #  # # ## # # #    #  # # #  #
# ##    #  # # ##      # # # ### ###### # # # # # ### ##        # ##  # #  # # #
# # ## # # # ##   # ### ## #   #                         # ## # #   ##  # ## # #
#               # #         ##   # # ## ## # ## ## ## # #  #   #  # # #  #     #
# # # # # # ## #  ## # ## # #  # # #   #    #     #   #  #  ##   # #   ## # # ##
# ## # #  #  #  ##   #  #  ### # # # #  # # # # # # # # # #  # #     #  #   # ##
#       ##  #  #   ##  #  #####  #  #  #  #  #   ###  #    ##  # ## #  ### #   #
################################################################################
OOORRRRRRRRRRRRRRORROOLLLLOOLLLOOOOOOOLLLLLLLLLOOOOOOOOOOOOOOOOOOOOOOOOOOORRROOOOOOOORRRROOOOOOOOOOOOOOOOOOOOROOOOOOOOOOOOORRRRRRRRRRRRRUULLLLLLULLLLLUUUUUUURURRRRRRRUUUUUUUUUUUUUUUUUUUUUUUUUUUUUUUUUUUUUUUUUUURRRRRRRRRRRRRRRRRRRRRRRRRRRUUUUULLLLLLLLLLLUUUUUUUUUUURUUUUUUULLLLUURRRRRRRRRRRRRRRRRRRRRRRROOOOOOOOOOOOOOOOOOOOOLLLLLLOOOOOOOOOOOOOOOOOOOOOOOOOOLLLLLLLLLLLLLLLLLLLLLUUUUUUUUUUUUUUUUUULLLLOOOOOOOOOOOOOOOOOOOOOOOOOOOOOOORRRROOOOOORRRRRRRRRRRRRRRRRRRROOOOOLLLLLLLLLLLLLLLLLLLLLOOOOOLLLOORRRRRRRRRRRRRRRRRRRRRRRRORRRRRRRRRRUUUUUURRROORRRUUULLUUUUUUUUUUUUUUUUUUUUUUUUUUUUUUUUUUUUUUUULLLLUUUUUUUURRRRRRUUUURROOOOOOOOOOOOOOOOOOOOOROOOOOOOOOOOOOOOOOOOOOOOOOOOOOOOROORRUUUUUUUUUUUUUUUUUUUUUUUUUUUUUUUUUUUUUUUUUUUUUUUUUUUUUUUUURROOOOOOOOOOOOOOOOOOOOOOOOOOOOOOOOOOOOOOOOOOOOOOOOOOOOOOOOOOOOORRRUUUUUUUUUUUUUUUUUUUUUUUUUUUUUUUUUUUUUUUUUUUUUUUUUUUUUUUUUUUUUUUUUUUUURROOOOOOOOOOOOOOOOOOOOOOOOOOOOOOOOOOOOOOOOOOOOOOOOOOOOOOOOOOOOOOOOOOOOOO