##########################################################################################
#   # #     # #      #   # # # # #   # #  ##  # ##### ##    # #   #    #  #  #  # #      #
# ##  # ## #   ## ##  # #  # #   ## #  ##    #   ###    ## #   # #  ##  #  # # #   # ## ##
#    # #    ## # ### #   #     #  # # #   ### ##  # ## #   ## #   #   #   #     # # ##   #
# # #   # # #  #  #   # ### # # # #     # #   # #    #  ##  #   #### # # # # ##   #   # ##
##   # ##  # #   ### #   # # #      ## # # # #  # # # # # # # # # # #      ### ##  ##    #
# # #  # #   ###  #    ##     # # #   ## #     #  ##  # # #    #     # # ##       #   ## #
# #   #    ##    ### # #  # # ##### #     # # # #   # #     # # ### #  #   # ## # ###   ##
#  ##   ## ### #  # #   ## #    #    # # #   ##  # #   # # ###  #    #  # # #  #      #  #
##  ## ##   ### #   # ## #  # #### ## #  # ##   #   ##   #  #  # # #  #  ##  #   ## # ####
#  # # # # # #  # ##   #  # # # #  #   ##  # ##   #  # ## ## #    ###   #   #  ##  ##    #
## # ##      ##   #  #  #   # #  #   #   #   ### # # #  #  #  ## # # ## # # ### ##    # ##
## #    # ###   #  ##  #  ##   # # # ## ## ## # ## # # # #   # # # # #     #     # ##  ###
#   ## # #  # #  #    ### # ##      #  #    #        #     # # #       #### ## #  # # # ##
# #        # # ## # #  #  #   # ###   ### ## # # # #  # ## ##    # # #        #  ##   #  #
## ## # ##   #     #  #  ## ####  ## # #   #  # # #  #   ## # # # ## # # # # ### # ## # ##
#   # # # # # # # # #   #   # # #  #    ##  #   #  #  # # #  # #    #   # #   ## # #     #
# #   # #  #     #  # #   # # #   # # ## # # ## # # # # #   #  ## #  # #  ## #      # ## #
# # #  #  # # ##  #  #  #  ##   #                         ## #  ####     #   # # # #  ## #
# # # # #   # # #   #  # ##  # #  # # ## # ## # # ## # # #    #   #  ## # ## # # #  #   ##
## #  #  # # #   # #  #  ## ### #  #   # #  #  #   #  ##   # ## ## #   #     # ##  #  ####
#   #  #   #   ##   #   #    #  # ## #  #  #  #  # # #   ##  #     # ## # ## #   #  #   ##
## # # # ## ## # # # # # ## # # #   #  # #  #  #  #  ### # # # # #   #   #   # ##  #  ## #
#                                 #  #   # #  # #  ##       ########   # ### # # #  #    #
# # # ## ## ## ## # ## # ## ## ##  # # ##  ##    ##   ## ### # # # # #  #  # #   # ## ## #
#  #    #  ##  #   #   # # #    # # #    ##   ##   # # #             ##  #   # ##  #  # ##
# # # # # #   ## #  ##  #  # ## #    # #   ##  # #  #    ## # ## # #  # # ## #   #  #   ##
# # #  ##   # #  # #   #  #   # # ##  ## #   # #  #  ###  # #  #  ## # #     # ##  #  ## #
#    # #  # #  # #  # # #   # ##    ##    # #  # #  #    # #  # # #    # ### #   #  #    #
# # #  # # #  #   ##    # # #  # ## # ## ## # #   #  # #    ##     ## #### # # ##  #  # ##
#  ####  #  #  # #   # #   #  ## #     #   ##  ## # #   # # ### # #    #     #   # ## #  #
# # #  ##  # #  #### #  ##  # #   # # #  ##   ##  ### ## #   ####  ## #  # # # # #  #  # #
#   # #  # #   # #   # #####   # #   #  #  # #  ##        ##  #   # #  ##  # #  #  #  # ##
# ##   #   # # #   ##   ##  # #   # # ## #    # # ## # # ##  #  # #   #   #  # ### ##    #
#    ##  # #  ### #   #    # ### #  #      # #    #  # #   #  ##  # ##  #  # #  #   # ## #
# ##    ###  # #   # # # ##  ###  #  ## ## #   ## # #   ## # # ###   ## # ## # # # ##   ##
# ### #  # #   ## # #   #   # #  #  #  #  # # ##  #  ### # # #     ##    #   # #   #  ####
#  #  # #  ## #  #    #  ##    #### # #  #   #  # # #     ### ### #  ## # ## #  ##  #   ##
# # ## # #  ##  ### # # #   # #  # #    # # #  # ### # # # #    ### ## ## #  # ### #  #  #
#          #  #  ###   # ##  # # #  # #   #   ## ##     #   ## #           # #  #    ### #
# # # ## #  #  #  #  ##   # #     #    ##### #     # ##  ##  #  # # # ####   # #  # # #  #
# # ##    ## # ##  # ### #   ## #### #    #  # # #  ##  #   #  # # # #     # # ## #    # #
#  #  ## # #      #   #   # #     # #  # #  # ###  ## #  ## # #  #   # ## #  #   #  # # ##
# #  # # #  # # ## ##   # # # ## #   #  # #    #  #    #       #  # # # ## # # # # #     #
#   #   #  # #   #  # #  ##  # #  ## # #  ## ####  # #  # # ###  #              #   # ## #
# ### ## #     ##  # ## #   #   #  # #  #  #   #  # #  ###    # # ## # ## ## # # ## #   ##
#         ## # # # # #    ## # #  ##   #  #  ##  #   #  #  # #     ##  ## ###     # # # ##
# ### # #  ##    #     ## ## # ## # # # # # ## # ## # # # # #  # ##  #   # # # # #   ##  #
#   # # # #   # # ### #                                      #  #  # # # #     #  # #   ##
## ##  #  # #  #     # # ## ## # # ## # # ## # # #### ## # #   #  #   ### # ##  #  #  #  #
#    #  #    #   ####   #   ###  # #  #  ## #  #    ## ##  # ## # ## # #   #   # #  #  # #
## ##  ## ##  # ##    ##  #  # # #  # # ##   # # ##  #   ##             # # ## #   #  #  #
##  # #     ###   ###    ## ## #  ##  # # ## ## ## ## # ## # # # # ## ##  #   # # # # ## #
#  ###  # ##   # #    # #      # #  # # # #                   #  # #   ##   ##   #   #   #
##  #  #     #### ## # #  # ### # #   ##    # ### # ### # # # # # # # #   # # # # # # ####
# # # # # # #  #  ###   # #        ##   # #  #  ##  # # ##  #  #    ## ##  #  #   #   #  #
#    #    ## #   # ## #  #  ## ## #  # ###  ###   ##   #  ## ## # ##    ##  #   ##  ##  ##
# ##  ###     ##     ###  # # ## # #  # # # ## # # ## # # ## ## # # ## # # ## ##   #  #  #
##  ##  # # ##   # #  # # #         #                                          # ### #  ##
###   #   ##   #  #  #      #### # #  # ## # ## # # # # # # # ## # # # # # ## #        # #
### ## ##   ##  ## ## # ###     #   # ##    # # # # ##  # # #  # #  # ## #  # # # ## # # #
##        ##   # #        # ## # # #   ####    ### #   # # # ### # #    # ##    ##  #    #
#  # # ##    ##  ## ### # # #  #  #  ##   ### # #  # #   # #    # #  # ## # # #    ### # #
# # ####  ###  #   #     # ###   # ##  ##    #   #  # # #  # # ##  ##          # # ## #  #
##   #  # # ## # ## ### #   # # ## #  #  ## # ## # #   #  #  ##   #   # # # # # # #    ###
#  #   ##                 ##  # #    ### #  # ## # ## # # ##   ##  ## # # ##        # #  #
# ####    # # ## # # # # #  #  #  # # #   # #                ##  #  #  ##  # ## ## #    ##
#  #  ## #  #   # ####  #  #  # # #     ##    ## ## # # # ## # # ## # #  ####  # #  ## # #
## # #  ## ### #   #  ## #  # #  # ### #  # #  #   #   #   #            #  #  #   # #    #
###  # ## # # # # # # ## # ## # ## # # ## ### ### # # # ##  # # ## # ##  #  # # #  ### # #
## #                                           #  # #    # #  ##   #  # #  #  # # # ######
#    # ############### # # # # # # # # ### # # # #    # #  # # # # # ## # # # #  #   # # #
# # #                 # #   # #  ### #    # #   # # # # # # #  ##  # # #        # # #    #
# # ## # ## # # # ## ##  ## # # #     # # # # # #  # # # #   #   ## #  # # # # #      ## #
#  #   #   ##  # #     #   #   ### # # # #   #  # ## # # ## # # ##  # #   #  #  # ###   ##
#### #  # #   #   ## ## # # ## ## # ## # # ## ##              #   # #  # # ##  #    # #  #
#   #  # #  #  ##                                # # # ## # # # ### # ##   # #   # #  # ##
# # ## # ## # #  # ## # # ## ## # # ############# # # # ### ##           ##    # #  ## # #
##   ##      # # #  # #  ##  #  ## #                          ## ## ## # #  ## # # # # # #
#  ##  # # # #     ###  ##  # #  #   # # # # ## # # # # ## # ##   # #  #  ##   ## ##     #
# #  # # ## # # ## ## #   # #  # # #  #  # #   #  #  #  # ##   # # ## #  #  ##  #    # # #
# # #  ##   #  # ##   # #### #    ## ## #  # ##  #### #   #  ##      #  # #    #  ##  #  #
#    #  # # # #   # # ##  #  ## ##   # #  #    #  #     # # #  # ## ### #  ###   #  #  ###
### # #  #    # #  #    #   # ### ##    ## # ## # # ## ## #  #   ##  # #  #    #   # ### #
# # # # # ## # ## # ## # # #         # # #  # #  #  #  # ## # ##   ##  ## #### ## #  #   #
#                            # ## # # #   #    #  #  # #   #   # ## # #          # #  ## #
# # ######################### ## # ## ## # # ## #   #  # # ## ## ##    ### # # # #   # # #
##                                       #   ## # ## # ##           ###  #  #   # # #    #
#  # # # # # # ## # # ## # # # # ## ## #   ##    #    #   ### ## ##     #  # # ## # # ## #
# # # #  #  #  #   #   # ##   #   #  ##  ### # ## ## # ##   #  # ## # # # #            # #
##     #### # ### #  ## # # #  # ####  #                # ### #    # #  ##  ### ## # #  ##
# ### ## # # # # # ## # # ## ## # # # # ############## ## #  # # #   ###  # #    #  #  # #
# #                                                    #  # ## ##  ##   #  # ###  # ## # #
#   ################################################### #        # ## # # ##   # # #     #
###                                                       ## # ## #    #     ##  # ### ###
#  # # # # # ## ## # # # ### # # # ## # # # ## # ########## # ##    # ### # ## # #       #
# #   ##  #  #    # # # ## ## # # ## # # # # ## ##               # ### # #     ## ## # ###
#   # #  #  ## # #                                 # ## # # # ##  ####   ## # #     #  # #
# #  ###  ##    ## ## ## # ## ## ## # ## # # # ### #  # # # # #  # ## ##    #  # ### #   #
# ##  # # # # # #  # #  #    #   ###   # #  #  # # # #   ###   # #    # ### # ##       # #
#  # ##   #  # # #    #   ##  # # # # #  ##  # #    #  #  # # #   # #       #   ## # # ###
# #  #  #  #       ##  # # ###    # # ##  # #   ###  # # ## ## # #   # # ## # #   # ##   #
#  #  #  #  # ## #  # #       ## #      # # ## ##   #  # #   # #  # #   #   #  # ##    ###
##  #  ## ## # ### ## # # # # #   # # #  ###     ## # # #  #     # # ###  # # # #   ## # #
#  #  #            # #  #  #   # #  #  #  #  # # # # ## # #  ###        # # #   # ##     #
##  #  ## ## # # # # # # #  # #####  #  # # #  ###   #  ##  #    ### ##  #   # ###  ## ###
# #  # ###  #  ##     #   ## ### #  #  ## ## #    # ## #  ## ###   ## # # # ##  #  #   # #
#  # #  # # # #   # # # ##    #   #  # # #     # #     # #       #     #  # #  # #  ##   #
##   # #     # # # ##     ## # # ## # #   # ## ## # # ##  ## # # ### ## #   ## # # # # # #
#  # ## # ##     #    # ## #     # ##  ##  #  #   #  #   # ##  #    #   # #  #         ###
# # #   # #  ## #  ## #  # ### ##  # #  ##   # ## # # ## #  # #  ## # ## #  #  # # # #   #
# #  # # # ##  # ## #  ##    #  # #   #  # # #  #   #  # # #  ## # ## ## ##  ##  #  # # ##
# # #        #        #   # #  #  # #   # #  # #  ##  #    # #              #  #  ##     #
##   ## ### # ## ### # ## ## # # # # # ## # ## ## # # ## ## # ############## # # #  ## # #
# ##    #           #                                                          ####  # # #
# #  # ### # # # ### # ### # # ## ## # # # ## # # # ### # ### ## ### # ## ## #   #  ### ##
#  #### # #   #      #   # # # # #   #  # #   # #  #     #    #  #   #  # # #  ## #  #   #
# #  ##    ### # # ### ##   ##   # # # ##  ### ## # ## ## # # # ### # # ##   #  #   #  # #
#   #  # #        #    # ##   ##########  #  #   #    ##  ## # ###     #   ##  # # #  # ##
# #  #    # # ## # ### #   ###   # # #   #  # # #### #   # # #  # # # # # #  #      #    #
##  # ## ###  #    #     ### ## ## # ## # # # # ## # ###      #   # ##    # #  ### ## # ##
# #     # # #### ## ## #      #                          ### # # # # ### ## #### #    ## #
# ### ##  #   #         # ## #  ## # # # # ## ### ## ### #                         # # # #
#       #  ## # # # ## # ## # ## # ## # # ## ## ### ## ## ######################### ##   #
## # # ## #   ## ## #  # #  #    #                                                     # #
# # #      ##  # # ####   #  ### # # ## ## ### # # ## # # # # ## # # ## ### # # ## # #  ##
# # # ## ###  ##    # ## #  ##     # # # # #   # #   #####   #  # ## ####    #  # #  # # #
# #  #   #  #   ## ##  # # #  # # # #     ### # ## ## # # ## # #  # # #  ## # ##   # #   #
# ## ## # # ## # # # #      # ## ## ### ## # ## # # # # # # ## ## # # # # ### # # # # # ##
#                      ## #                                                              #
##########################################################################################
RRRRRRRRRRRRRRRRRRRRRORRRRRURRRRRRRRRRRRRRRRRRRRRRRRRRRRRRRRRRRRRRRRRRRRRRRRRRRRRRRRRRRROOLOOOLLLLLLLLLLLLLLLLLLLLLLLLLLLLLLLLLLLLLLLLLLLLLLLLLLLLOOORRRRRRRRRRRRRRRRRRRRRRORRRRUURRRRRRRRRRRRRRRRRRRRRROOOLLLLOOOOOLLLLLLLLLLLLLLLLLLLLLLLLLLLLLLLLLLLLLLLLLLLLLLLLLLLLLLLLUUUUUUUULLLLLLOOOOOOOOOORRRRROOOOOOLLLOOOOOOOOORRRRRRRRRRRRRRRRRRRRRRRRRRRRRRRRORRRRRRRRRRRRRRUUUUUUUUUUUUUUUURRRRRRRRRRROOOOOOOOOOOOOOOORRUUUUUUUURUUUUURRRRRRRROOOOOOOOOOOOOOOOOOOOLLLLLLLLOOOOOOOOOOOOOOOOOLLLLLLUUUUULLLLLLLLUUUUUUUUUULLLLLLLUUUUUUULLLLLLLLLLLLLLLLLLLLLLLLLLLLLLLLLLLLLLLLLLLLLLLLLLLLLLOORRRRRRRRRRRRRRRRRRRRRRRRRRRRRRRRRRRRRRRRRRRRRRRRRRROOLLLLLLLLLLLLLLOOOLLLLLLLLLLLLLLLLLLLLLLLLLLLLLLLLLLLLLOORRRRRRRRRRRRRRRRRRRRRRRRRORRRRRRRROOOOOORRRRRRRRRRRRRRRRRRRRRRROOOLLLLLLLLLLLULLLLLLLLLLLLLLLLLLLLLLLLLLLLOOOOLLLLLLLLLLLLLLOORRRRRRRRRRRRRRRRRRRRRRRRRRRRRRRRRRRRRRROOOORRRRRRRRRRRRRRRUURRRRRRRRROOOOORRRRRRRROOOOOLLLLLLLLLLLLLLLLLLLLLLLLLLLLLLLLLLOOOOORRRRRRRRRRRRRRRRROOOOOLLLLLLLLLLLLLLLLLLLLLLLLLLLLLLLLLUUUUUUUUUUULLLLUUUUUULLLLLLLLLLLLLLOOOOOOOOOOOOOOOOOOOLLLLLLLLOOOOOOOOOOOOOOOOOOOOOOORRRRRRRRRRRRRRRRRRRRRRRRRRRRRRRROOOOORRRRRRRRRRRRRRRRRRRRRRRUUUUUUURRRRRRRRRRRROOOOOOORROOOORRRRRRUUUUUUUUUUUUUUUUUUUUUUUUUUUUUURROOOOOOOOOOOOOOOOOOOOOOOOOOORRRRUUUUUUUUUUUUUUUUUUUUUURROROOOOOOOOOOOOOOOOOOOOOOOOOOOOOOOOORROOOOR