##########
#        #
######## #
#        #
# ## # # #
#   ###  #
# ## # # #
#       ##
##########
OOOORRRRRRROO