########################################
##       ## #  # #  #    #   # #  #  # #
# ## # #      #  ##  # #  # #   #   #  #
#   #  ## ###   #   #   # #  # # ##  # #
## # ## ##   ## ## ## #  # #        #  #
#     #  ###          # #    # # ## ## #
## # # #   # # # # # # # # # #### #  # #
###    ### # ##  # # #      #  #    #  #
##  # #  # ## ##  #    # # ###   ## ## #
#  #  # #   #  # # # # #  # # ##  #  # #
# #  #   # # #      #   # #   #  ### # #
##  ### #  #  ## # ## #  # # # #  # ## #
# #  #    # # #  ##  #  #        #  #  #
#  #  # # # #  #   #  ## ## ##### # ## #
# ## ###    # #  ### # # #           # #
#     # # #    #          ## # # # # # #
# # ##    # # #  # # #####  #   # #  # #
#  #   # #  ## ## #      # ### #   #   #
##  ##  # #       # # # #   #  ###   # #
# #    #    ## ##  #   # # # ##  # #  ##
# # ##  ## #  #   #  ###   # ## # # ## #
#   #  ### ##  ##  #     #             #
# ## ## # # # #   # ##### ############ #
#             # #                      #
########################################
OORROORRROOORRROORRUUUURRRRRRUUUUURRRRRRRRRRRRRRRRRRRRROOLLLLLLLLLLLLOLLULLLLOOROOLOOLLLLOOOOOOOOOORRRRUUURRORRRROORRORRRRRRRUUULLLUUUUULLLLLUURRRRRRRRRUUURROOOOOOOOOOOOOOOO