######################################################################
## # ###   # #    #   #   #   # #  #   #  #  #       #  # #  #   #   #
#     #  ##   # #  ##  ##  ## # ## # ### # # # # ## # #     # # ## # #
# # ## # # ##    ##   # # ##                    #  #   ## ##    # #  #
#  # # #      ##   ##   #   ## #### ########## #  # # #    # ## #  # #
# #  #  ## # ##  ##   #  ##  #     #            #   #   ##  #   # #  #
#   # #  ## ## #  # #  ##   #  # ## ## ## ## ##   ##### #  #  #    # #
# ##  # #   #   #  #  #  ##  #  #    #  #  #   # ## #  # #  ##  # #  #
# ## #   ## ## ## # # ## # # # # # #   #  ### #      #    # # # #  # #
#     # #                    #    #  #  #  ##### ########       # #  #
# ## #   # ## #### # # # # # # ##  # ## # # # #      #    ## # #   # #
#   #  ## #  #     #  #   #    #  #    # #     ## # # # # #  #  # #  #
# ##  #    #   # #  ##  ##  ##  ## # ### ## ###  # #   ##  # # #   # #
#  # ### #  ### #  #  ##  #  # #              # #   ##    # #  # ##  #
##    ###  #     # # ## # # #  # # ## # # ## #    # #  ##   ## # # # #
# # ## ## # ### #       #   ##  #    #  # #  ### # # ## # ## ##  #   #
#               ## # # #  #   # # # # # ####              #    # # # #
# ### # # ### #    ##  ###  #  ##  #      #  ## # # ## # ## ##    #  #
#   # #  #     # #   ##  ##  # #  ### # ##  #    ### # ##  ##  ##  # #
# # #  #  ## ## ## #    #  ## # ## ###   # #  ##  #  ## # ## # #  ## #
##  ##  ##  #       # #### #  #     # ### #  #######         ## # #  #
# #   #   #  # # # ###  #    # ## ##  # #  # ###  #  ## ## #  #    # #
#   ## ## # # #   ###  # # ##   #   #   # # # #  ### ###  ## # # #   #
# # #    ##   # ## # # #    # #  # # # #  # # # # ##  #  #   #  #  # #
### ## ##  ##  # # # #  # ##   # #   #  #   #        # #   #   ###  ##
#    # # # ## ## # # ## # # # # # ## # # ## ## # # #   ## #  # ### # #
### #                                           #  ###   # #  # #    #
# #  # # ## # # ## # ## # # # ################## #   # # #   #   # # #
# # #  # # #  # #  #   #   # #                    # #   ####   # # # #
#    # #   # #   #  # ### ## # ## # # ## # # ## # #### # # # #  # # ##
## ##   ##  ## # ## #  #  #     #  ##  ##  #  ##    ####      #      #
## # # ## ##    #   # ## # # # # # # #  ## # #  # ## #  ## # #### # ##
#    # #   # # #### ##  #   #     #  # #   #  #        ####   #  #####
# ##     ## # # #  #  #   ## ## #   ### # # #  # # # ## ## # #  # # ##
##  # # # # # #  #   # ##        # # #      # ##  #   #       #   #  #
# # # ##  # # # # # ##    # # # #     # # ## ## #  # # # # # ### #  ##
# #  #  #              # #   #  ## ##  #  #       #     # #  ##    # #
#  # # ## ## ## # # # #  ## ###   #  ##  # # # # #  # #   ##    ##   #
##         # #  # # # # #  # #  ### # # #   #####  #  # ## # ##   # ##
### ####### # ## # # # # # #  ##       # # # # # #  ###  #     # ##  #
##                           # # #### #      # #  ##    # ## #  ## # #
# ##########################         # ### # # ##    ##       #    # #
#                            # # # #      #       # #   # ## ### #  ##
######################################################################
RRRRRRRRRRRRRRRRRRRRRRRRRRROOLLLLLLLLLLLLLLLLLLLLLLLLLOORRRRRROORRRRRRRRRRRRRORRRORRRRRROOLOOOORRRRRRRRRRRRRRRRRRRUUUURRRUUUURRRUUUUURRRRROOOOOOOOOOOOOOOOOOOOOLLLLLLLLUUUULLLLLLUULLLLLLLLLLLLLLLLLLLLLLLLLLLLLLLLLLLLLLLLUUUUUUULLOLLOOOROOOOOOOOOOOLLOORRRRRRRRRRRRRRURRROOOOOOOORRRRRRRRRRUURROOOOOOOORRRRRRRRRRRRRRRRUULLLLLLLLUUULLUUUUURRRRRRRRUUURRRRRRRRRRRRROOOOOOORRRRRROOORRUUUUUULUUUUURUUUURURROOOOOOOOOOOOOOOOOOOOO