############################################################
# #  #    # #     #    #  # # #  ## #            ##      # #
#  #  # #    ## #  # #  # #    #     # # # # ###    # ## # #
##  #  ### #   #  ### # # ## ## # # #  # # #    # # ##   # #
# #   ### #  ## #  #               # #  ## ## ##   #   ##  #
# # #  #   # #    #  ## ## ## # # #    #  #     ## # # ### #
# # # # ## #  # # # #   ##  #  #   # #   # ## #  #  #   #  #
#  #  #  #  #  #   # ##   # # # # # ## #   #   # ## # #  # #
# # #  # # #  # # #   # #  ## #         # # # ### ## # # # #
#     #  #   #      # #  #   # # # # # # #   # #           #
### #  # # ## ## ### # # # ##    # # # # # #    # # # ## # #
# # # #                   ### # # #   #   #  # # #  #   #  #
#  #    ## # #### # ### ## # # #   # ## #   ##   ## # ##  ##
##  ###   ###   # #   #  #   #   ## ##  # # #  ## ## #   ###
#  #    ## ## ## # ### ## # # ## ## # # ## # #       # #  ##
##   ##                                       ## # #  #  # #
#  ##   ########## ## # # # # # # ## # ## #### # # # # #   #
##   ###          #   #  ###  #  #   ##         #   #  ## ##
#  # #  # ### ## ###### # ###  ## ##   ## ## # #  #   #  # #
##  # # #   #  #  #    ##  ## ##    # # #   #   #### #  #  #
#  #      ## ##  # # ##   #  #   ##  #    #### ## # ## # # #
### # # #     ##   # # # # # # ### ## # #   # #     #    # #
# #  # #  ## #   ##                   ##  #   # # ## # # # #
#   #   # # # ##   ## # ## # # ## # #   #  # # #   #    #  #
# #   ##       # ##   ##  #  # ##  ## ### #  #  # #  # ### #
##  # # # ### #    ##   #  # #   # #       ##  #   # #  #  #
# #  #  # #  ### #  ### ## ## ### # ####### ## ## # # # ## #
# # # #     # ## # #                                       #
#       # ###     # ## # # # ### ## ### ## ## ## ## # ## # #
# ## # #     ### ## # # # # ## ### ## ## ## ## ### # #  #  #
# ###   ### #                                          ### #
#  # ###   #  # # ## # ## # ## # ## ## # ## ## # # # #  #  #
# ## # ## # ## # # ## ## # # ## ## ## # # ### # ##  #  ### #
#                                                 # ##  #  #
############################################## # # # # # # #
#                                               #          #
############################################################
RRRRRRRRRRRRRRRRRRRRRRRRRRRRRRRRRRRRRRRRRRRRROOLLLLLLLLLLLLLLLLLLLLLLLLLLLLLLLLLLLLLLLLLLLLLOOOOORRRRRRORROOOOOOOOOORRRRRRRUUUUUUUUUUUUURRRRRRRRRRRRRRRRRRRRRRRRRRRRRRRRRRRRRRUUUUURRRROOOOOOOOLLLLLLLLLLLLLLLLLLLLLLLLLLLLLLLLLLLOOLLOOORRRRRRRRRRRRRRRRUUURRRROOOOOOOOOOLLLLLLLLLLLLLLLLLLLLLLLLLLLLLLLLLLOOOORRRRRRRRRRRRRRRRROOLOOOOORRRRRRRRRRUUUURRRRROOOOOOORRRRRRRRRRURRRORRRRRUULLUUURURUURROOOOOOOO