################################################################################
##  #  #    # ### #       #  # # #    #  #   # #       ###     #               #
#  # #  # ##   #   # ## ##  #    # # #  # # ##  ### ##  # # ##   ## # # # # # ##
## #  # #  ## # # #   # #  # # #    #  #  # #  ##  # ##      # # # #   ## # # ##
##  # #   #        # # #  #   #  ## # #  #   #   #      # # ## #    ##   # # # #
#  #  # #  ## ## ##  #  # # #  ## # #  #  # #  # # ## ##  ##  #  ### # ##  #   #
##  # #  #   #    ##  # #  # #  # #  # # #    #  #  # #  #   # #      #   # # ##
#  #   # ###  ## #  #    # # # ## # ## # ## # ## # # # # # #     # # # # #     #
##  # ###  ## #    # ## #                    # # ###   ## #  ###  # ##   # ## ##
#  #   # #  #  # ##  #   # # ## ## # ## # ##    #   # #    # #   #  #  ## # #  #
# #  #     # #    ##   ##   #   #  #  # #  # ##  # #  ## #   # # ## ## ## # # ##
#  ##  ### #  ## #  ## # # # ##  #  #  #  #    #   # #  ## #  #                #
# #  ###     # # # # # # # # # #  ##  #  # # # # #     #   # #### # # ## # ### #
# ##     ###                   # #  #  ##     ###  ## ### ##  #    #    # ##   #
#    ####    # # ## ## ## ## # # # # ##   ## ### ##  # # #   ### #  ## #     # #
## ##    ### ##  #  #  #    ## #   #   ### #  #   ## #   # ## #   #   # # ## # #
# #  # #       ##  #  #  # ## # ###  #       #  #      ####   ## ### #   # # # #
#   #   # ## ## # ###  ####     #  ## # ####   #  ### #  # ##     #   ##     # #
###  # ###       # # # # #  # ##  # #   #    ##  #   ###   # # # # # #   ## #  #
# ##  ### ## # ##  #  #   ##     #  ## # ###   ##  #  #  ##    #    # ## # # # #
#    # #      #   ###  # #  ## ##  #  #      #    ### ## # # # ### #   ##      #
## #     # # # # # # # # # # # ## #  ## # ##  ## # ### #    # #   #  ## # #### #
#  # # #  #                         #  # #   ## #   #  # ## #   ##  #    #     #
##  # #  # # # ## ## # # # ## ### ####     #      #   #   ##  #   #  # #  #### #
#  #   #    #  #   # #  ## #  #     # ## ##  ## #  # ### # # #  ### ###  ##  # #
# #  #   ###  #  # ##  #    ## ## #   #  # # # # # #  #     # # #    # # # #   #
#  ## # #   #  # ##   #### ##  ## # #  ##         # ## # # #    # # #  # # ### #
# #   ##### ##### ## # #  ## #     #  ### ## ## ##  #     # # ## #   #       # #
### #   # #    #   # #  #    # ## # ## # # # # ## #  #### # # ## ## #  # ## #  #
#  #  #     # # # # #  #  ##  # #      #            #                # #  #  # #
## # #  # #  #  # #  #  #   ##    # # #### # # ## ## ## ## ## # ## #    ##  ## #
#    # # ## # # # # ## ## ##  # # ## # # ### #  #    #  #    ##   #  # #  # #  #
# # ###                    ## # #      #      ## # # # # # ###  #### #  #    # #
## # # # ## # ## ## # ## #     #  # ## # # # #    #  # #   #   ## ###  # ## #  #
#  #    #  ##  ##  #   # # ## # #  ## ##  ##   # #  # # ##  ##     #  #      # #
## # ##  # #  # # #  #  #  ###    #   #  #   #  # # # #  # # #### #  #  # # #  #
##    # #   #   #  ##  # #  # # # # #  ## ##  ###  #    #        # ##  # ## ## #
#  # # # # ## ##  ##  ##   #   #   # #       #    # # #  # ## ## #  # #        #
###              #  ##  ##   #  # #  ### # #   # #   # #   # #  ## ### # # # # #
#  # # # # ## ##   #  # ## ###### # #  #  ## ## ### #   ##   ##     #    # #  ##
##  #  ####   ## ## #        #    #   ## #    #  #  # ## # #    # ##  # # #  # #
# # # #  #  #   # #  ## ## ## # #   #   ## # #  # #         # ## #  ##  #   #  #
#    #  # # # ###   #  # #     ## #  # #  #    ## # ## # # ##      #  #####   ##
# ## # #   #      ## #     ## #   ###   #  # ##       ###    # ###   #  # # #  #
## #    ##  # ###### # ### # # ##    # # #   #  # # #  # # ##     ##  #   #  # #
#   # #   #       #  # #          ###  #   #  # ## ### # ####### ### # ##   #  #
## # ## ## ## # #   # #  # ## ## #  # # #### ##  #  ###    ##   # # #    ## ## #
#             #### #   ## # ### # #  #  #    #  ## # # # ##   #   # # # # ## # #
# ## ## # # #   #   ##              # #  ###  #             ## # #   #     #  ##
#  #   #  # ## ## # #  # # ## # # #     #  # #  # ## ## ## # #  ### # # # #  ###
# #  ##  #   #   # ## ##  # # ###  # ##  #   ## # #  #  #      # ## # #  #  # ##
# # ## #  # ## ##  # #   ## ##    #    #  ##   #   #  ## # # #         # ##    #
#  #    ## #  ##  #   ##      ###  ## # # #  # ## # ##   # #  ## ### ##    # # #
# # ### ## ## # #  # #   #### # # # ##   # #  #  #  ####    #####   #  # ##  ###
#                 #  # #     #    #  # #     # #  #  # ### #  ### ## # #  ##   #
## # # # ## ### # # ## # # ##  ## # # #  # # # # ## ##      #  #   # #   #   # #
#  #  #   #   ###     ##  #  # ##     # # #         # ## # # # ### # ## # # # ##
##  #  # # # #    # # #  ###  #   ## # #  ## # # ##     ##                     #
#  #  #  # ## ### ##  ##  #  # ##  #    #     # #   ## #  # # # ### ## # # # # #
##  #  ##           ##   # # # #  # # #  # ## #  ## ### #   ##    #  # #  # #  #
#  #  ## ## # # # ## # #     # ##    #  #### ###  #  #   ##  # ## # # #  #   # #
# ## #       # #  #   #  # ##     # #  ###    #  #  #### # #  #    #    ## #   #
#   # # # # ## ##   # ##  #  # ##  # ## #  # # # ##  #      #  # #  # ##  # ## #
# ##  # ##  #   # ## #   # #  #   ## #  # # #     # #  # # ## #   ## ## #      #
##   # #  #####    #  ##     # ## #  ## # #  ## # #  # # # # # # #        # ## #
## #    #   #  ## # #  # #####      #   # # ## #    #   #       #  ### ##  # # #
# # # #  # # #      ##        ### ## ## # # #  #### ## # # ### ## ##   #  #    #
#     ##     ## # ## # # ## ##                #          #    #  #   #  #  # # #
## ###  # ##    #  #   # #  #  # ## ## # # # # ## ## ## #  ##   #  #  ## # ##  #
# #    # #  ## #  # # ##  ## # #  #  # # # # # #   # #   # # # # ## ##    #  # #
#  ###     # ## # # # #  # #  # # # ## # ###    # #   # #     #       ## ### # #
##     # #          ## #     #   ###    #    ###   # # # # # # # # # ##   ##   #
#  # ## #  # #### #  # # # #   #  ### ##  ## #  # #  #      #   ##  ## # #  ## #
##  #     ###      ##     # # #### #  #  #     # ####  # # #  #   #    #  # #  #
# ###### #### # # #  # # #  #  #    ##  #  # # # ##  ##  #   ## #  ### ## #  # #
# # #     ##   ## # # ## # #  ### ##  ## ##   ##   # #  #  # # ####        #   #
#     # ##   ##             ## #    # #    # #   # # # ### #    #   # # # # ## #
# ####  ## ##   # ## # # ## #   # ##   # # #  ##  #   # #   # #  ##  ###    #  #
##     #     # #   # # ### # # #  #  #  #    # # #  ###  # # # ##  #### # #  # #
### ###  # #  #### #  #         #  # # #  ##       #   #         #   #  # # #  #
## #    # # ## # #  ## ## # ## #  # #  # # # ## ##   # # # ### ### ##  #  # ## #
#   # ##           #    #  ### # ## # # ## ### # # # #  #  #  #    #  # # #  # #
# #  #   ## ## # #  # #   # #                       # ## #   # ## # #   # # ## #
##  # # #   #  ##  # #  # # ## # # # ## # ### # ## ##  #   #        ### # # #  #
#  ##  #  ####   # #  # #    #  ### #   #   # # #     #  # ## # # ##      #  # #
##    # ##  ##### # #  #  # # #  #    # # # # # ## # #  #    #  #   # # # # ## #
# # ##    #  #    #  # ##  #    #  # ###   #   #   #  ## # ## #  # #  ### # #  #
#      # # #  # # # ##  # # ## ### # ## # # # #  #  ##         #  #  #    #  # #
## ### ##    #  # #    #  # #   # # #     # ####  ## ## ## # ## #  # # ## ## # #
#  #     ###   # # # ## #    ## # # # # #     #  #    ##   ##   # # #   #  # # #
# # ### #   ##            # #  #    #  ### # ###### #   ##  # # ##   # #  #  # #
##  #    ##    ### ## ## # # #  # #  ## # # # #  ##  ##    #   #  ##  # # ## # #
#  # ###    ##    ##   # #    #  #  # # # # #  #   ##   ##  ##   ##  #  #  # # #
# ## #  ###  ## ##  # # #  # #  ## #  # #    # # ##   ##   # ## ## # # #  #  # #
#     # # # #  #   # #   # #  #    # #   # ##  #   ###   #              #  # # #
# # # #       # # ## ## # # # # ## #  # #     #  ### ## #  # # # ### # #  #  # #
## ##   # # # #                  # # #   # ##  #       #  ####  #    #  #  # # #
##    # # ## #  # # ## # ## # ##  #   # ###   #  # # ## #  #   ### # # ## ## # #
#  # ## ## # ##  ## # ## #  ###  # # ## ## # # # ## ##  ###  #  # # #  #  #  # #
##  ##          #     # # ##   #                       #   # # #     #  #  # # #
# ##   ## ## ##  # # ##     # # ######################   #  #   # ##   #  ## # #
#   # #######   #  ##  ## #                            #  ##  ###  # # ## #  # #
## # # ## ## ### ## # ## # # # # # ## # # # # ## ## # # #  # #   ##  #     # # #
#                             #  # #  #  #   #    # #    #  #  #    #  # ##    #
################################################################################
RRRRRRRRRRRRRRRRRRRRRRRRRRROORRRRRRRRRRRRRRRRRRRRRRRRRROOLLLLLLLLLLLLLLLLLLLLLLOOOLLLLLLLLLLLLLLLLLUUULLLLLLLLOOOORRRROOOORRRORRRRRRRRRRROOOOOOOOOOORRRRRUUURRRRRRRRRRRRRRRRRRRROOOLLLLLLOOOOOOOOOOOOLLLLLLLLLLLOOOOOOOOOOOOOOOOOOOLLLLLLLLLUUUUUUUUUUUUUUUUUUUUUUUUUUUULLLLLLLOOOOOOOOOOOOOOOOOOOOOOLLLLLLLLLLLLLLLLOOOOOOORRRRRRRRRRRROOOOOOOOOOOOOOORRRRRRRRRRRRRUUUUUUUUUUUUURRRRRRROOOOOOOOOOOOOOOOOOOOOOOLLLLLLLLLLLLLLLLLLLLLOOOOOOOOORRRRRRRRRRRRRROOOOORRRRRRRRRRRRRRRRRRUUUUUUUUUUUUUUUUUUUUUUUUUUUUUUUUUUUUUUUUUUUUUUUURRRRRRRUUUUUUUUUUURRROOOOORRRRUUUUUUUUUUUUUUUUUUUUUUUUUUUUUUUURRRRRRRRRRRRUUUUUUUURRROOOOOOOOOOOOOOOOOOOOOOOOORRUUUUUUUUUURUUUUUUUUUUUUUUUURROOOOOOOOOOOOOOOOOOOOOOOOOOOOOOOOOOOOOOOOOOOOOOLLLLLLLLLLLLLLLLLLLLOOOOOOOOOLLLLLLLLLLLOOOOORRRROORRRRRRROOOOOOOOOOOORRRRRRRRRRURROOORRRRRUUUUUUUUUURRROOOOOOOOOOOOOOOOOOOOOOOOOOLLLLLLLLLLLLLLOOOOOOOOOORRRRRRRRRRRRRR