######################################################################
## # ## ### # #  #      #          # #  # ###   # #                # #
#        #  #  # # ## #  ## ## # #     #   #  ##  # # # ## # ## ## # #
# # # ##  #   #   #  # # #  #   #  # #  # ## #   #### #   # # ## # # #
## ##  # ## ##### # #  #  #  # # #  # ##      ##  #   ## #         # #
#  #  # #   # # # #  #  #   # ##   #     ## ##   ####  # ## # ## ### #
## # #   ##   #     #  # ## #   ## # ## # # # ## ## # ###    #  #    #
#  # # ##  # #  # #   #       ##    #  #               # # # # # # # #
##       # #  #  #  #   # # ##  ## # #   ## ## ## ## #    #       #  #
#  # # # #   # ##  # ##  #  # # #  #  ##   #    # #  # # #  # # ## # #
# ###   ### #    ##     ###   # ##   # # ### # # # ## # # ## #     # #
## # # # #  # # #   ###  #  # #    ##       ####              # # #  #
#         # #  # ###    ## ### ### #  ## ##  #   # ## # # # # #  # # #
## # # # #    #  #  # # # ###  # #  ## #  ##  # ##  #  #  # # # #  # #
# #   ##  ## #  #  # #     # # # # #     # # # #   # # # # #  #   #  #
#  # ##  # # # # # # ## # #         # ##    #  ###   ## #   #   #  # #
##     #                 #  ## ## # ##   ##   #    #    # #   #  ##  #
### # #  # ## # ## # # # # #     #    ## #  # # ## ### # ### ## #  # #
## #   # # #  # #   #   # # ## # # # #   ##  # #     #    #    # #   #
#   # # # # ## # # #  ##     # # # #  # #   #  # # # # ###  ## #   # #
###               # ##  # ##    #  # # #  #   ###   #  #   ####  # # #
#   # # # # # # #    ##   #  # # ## #  ###  #  # # # ### #  ## ## #  #
## # #   ##  #   ###   # ## #         #   # ###         ## #       # #
# #  ## #  #### ##  # # ## # # # ## #  ##      # # ### ## #  ## ##   #
# # # ## # # #  #  # #       # #   # ##   # ###  #    ##   ##  #  ## #
#        # # ##   #  # # # #    # #  # ## # #  ##  # ##  ## ## ##  # #
# # # ##        #  # ## # #  # # ### # # #    #  #  #   #       ##   #
#  #  # # # ## # #    #   ###  #  #       # ## #   #  #  # # ##    # #
# # ##     #      ## ### #   #   # # # # ##    # # # ## # # #   # #  #
#     ## ##  # # # # ##   # ## ###    ## #  # ###   #     #  ### # # #
# ## #     ##   #      ##      #  ## #    # ####  # # ## #  ##       #
#   #### #   # ### # # #  ## #  # #  # # #    #  #   ##   # # ### ## #
# ## #  ### #   #  #  #  ## #  ## ##  #  ## #  # ## ## # #  # #  #   #
#    ## ###  # #  #  #  #   ##       ###    ## ##          #  # #### #
# ##     #  #   # # #  # ##    # # #  ### #   # # ## # # #  #    #   #
# # # # # #  # #   # #     ## ## # # # # # ## #   #   #  # #  # #  # #
#    ##    # ## ###    # # ###  #  ##        ### #  #  # # # #   ##  #
# ###  # # ## # #   ## # ## # #   # # # # ### # # # # #  #  #  #  ## #
#     ##### # # ## #    #   #  # ##    #  # # #   #  ####  ### # # # #
# # ## # ## #    # ### #  #  #  #   # ###   #   ## ## #  # ### #   # #
# ##          # #    # # #  ### #####  ## ### ##    #  #    #  # # # #
#    #### # # ## # # # #  #  #        #        # ###  # ## ### #  #  #
# ##     ##  #   #  # # ##  #  # # ##  # # # #      #      ##  # ### #
# ## ## #  ##  #  ##       # ## # ##  #   #  # # # #######   # #  #  #
#   #  #  # # # ##  ## # #          #  # #  #   #   #      # # # # # #
# # # #  #        #    ## ####### #   ###  ### ### #  ####  ## # #   #
#  #   # # # # # ### ##           # #  # #  #   ### ##     #   # # # #
# # # #    ##   # # #   ##### # ## ## #   ## # # #  ######  ## #  #  #
#       ##   # #  #  # #    #  #        ##       ##  #     # # # ### #
# # # #   # # # #   # # # # # # # # # ##  #### ##   # ## # #   #  #  #
# # # # #  #  #  # #  #  #   ##  ###     #   #    #   # ## # # # # # #
#  # #   ##  # #    #   # ##   #  # # # #  #   ##  ###      ## # #   #
# #  # #  # #   ## #  #    # ### #     # # ###   ### ## ## ##  #  ## #
#   # ## ##  # ##   ## ## #  #    # # #  ##    ##     ## # # # # #   #
# ##  # ##  #    # # # #  ## # ## ##   #   # #    # ## #   #   #  ## #
#  # #    # ## ##    #  #     #     # #  #  #  # ###     # # # # ### #
# #   # ##   #   ## # #   # #  # ## #   # #  # #  #  # # #  ## #  #  #
#  # ## # ## ## # # #  # #  # # # #   ##  # #   ## ######  #   # ### #
##                   #   ## #   #  ##    # # # ##    # # # # ##   #  #
## # ## # ## ## # # # ##  # # ## #    # ## # #    ## #     #   # # # #
#   #   #  # # ## #     ##  # #  ## # # #      ##  ##### #   ##    # #
## #### # ###  #  # # ##  # #  #   #   #  ## #   ##  #    # #  # # # #
#   # ##   ## #  # ##   # # # # # # # ###   #  #    #  # #    #   #  #
## #    ##    ## #    # #   #          ## ## #  # # # # # # # ## ### #
# # # ##  # ##  ### # ## ## # ## ### ##       ##   #  # #    #    #  #
#      # ## #  ###  #       #  ##   ##### ####  ## # #   ## #### # # #
# ## ### # # # ## ## ####### ## # ## ## #      ## ## # #   # #   #   #
#  #                                      ## #      # #  #     #  ## #
# # # # # # # ## # # ## # ## # # ## # ###  #  # ## ##  ##  ## # #    #
#    #  #  #    ## #  # #   #  #  # #    # # # # ##   #   #     ## # #
# # ###  #  ## #    # #  # #  ###  #  ##  #         #  # #  # #   #  #
######################################################################
OOOOORRRUURRRRRRRRRRRRRRRRRRRRRRRRRRRRRRRRRRRRROOOOOOORRRRROOOOOOOOOOOOOOOOOOOLLLLLOOOOOLLLLUUUUUUUUUUUUUUUUUUUUUUUUUUULLLLLLLLOOOOOOOOLLUUUUUUUUUULLLLLLOOOOOLLOOLLLLLLLLLLLLLLLLLOLOOOOOOOOOOOOOOOOOOOOOOOOOOOOOOOORRRRRRRURRRRRRROOOOOOLLLLLLLLLLOOOOLOOOORRRRUUUURRRRRRRRRRRRRRROOOOOOOOORRRROOOOOORRRRRRRUUUUUUUUUUUUUULLLLUUUUUUUUUUUUUUUUUURRRRRROOOOOORRRRUUUUUURRROOOOOOOOOOOOOOOOOOLLLOOOOOOOORRRRRRRRRRRRROOOOOORRRRRRRRRRRRRUUULLLLLLLUURUURRRUUUUUUULLOOOOLLLLLLLLLLLUUUUUUUUUUUUUUUUUURUUUURRRRRRRUUUUUUUUUUUUUUUUUUUUUUUUUUURROOORROOOOOOOOOOOOOOOOOOOOORRUUUUUUUUUUUUUUUUUUUUUUUUUUUUUUURURRROOOOOOOOOOOOOOOOOOOOOOOOOOOOOOOOOOOOOOOOOOOOOOOOOOOOOOOOOOOOOOOOOOO