##################################################
#             ## #               #   #    ##  #  #
# ## ## # # #     ## ## # ## ## ####  # #   #  # #
#  #  ##  ### ## # #  # # ## # # # # # ## # ## # #
# #  # # #    # #  # # # #               #     # #
# # #  #  # #   ## #     # # # ## ## # ##  # # # #
#  # #  ## #  ##     ## #  # # # # #  ## # # # # #
# #    # # ## # ## #  # # # # #      #      #    #
#   # #           #  #  # #     #### # # ### #####
# # # ## # ## #### #  #  #  ###    #  #  #       #
#  ##  #  # #    #   # # # #    # #  # # # # # ###
# ## ## ##    #### #   ## ### # # ## #   #  #  # #
#         # # #   ## #     #####   # # # # ### # #
# ## # ### ## ## #    ## #  # # # ## # # #  #    #
#   # #           ## # ## ##        #### # # # # #
# # #   # ### ## # #      #  # ## ## #   #    #  #
#  # ##  #    # #    # # #  ###    #  ## # # # # #
# #    ## # #    # #  #   ## # ## # #       #  # #
#   # # # ##  # ###  # # #      # # # ## # # # # #
# ## #  #   # #### #    ### # #      ## #    #   #
#      #  # #   #    ### # ###  # ##     ## ## # #
# # ###  #  # ## # # # #    # ##   # ## #   # ## #
#  #   ## # #     #  #   ###   ## # # # ## ##    #
# # ##        # #  #   ##  # #      #  #  ## # # #
#     ## ## ###  ## # #  #  # # # #   ###     ## #
# ## #    ##   # #      #  ##   # ## # # ### #   #
# ### ## # ### ## ### # ## # # #   # #   # # # # #
#  ##                  #     #### # # # #     #  #
# #  # ## ## ## # # ##  ## ##  #    #     ## # # #
#   ##  #  #   #   ### #   ## # ## ### # # # #   #
# #   # ##  # # # # # # ##          #   #     ## #
# ### #   # ##  # #   #    ## # # ##  # # ####   #
#   ##  #  #   ### # # # # #### # # # # #     ## #
# #   ## # ###  #  # #  #   #   # # # #  ## # #  #
# ### #  ##  # # # # # # # ### ###   ## ## ##  # #
#    #  #   #            #  #   # ##       #  ## #
# #### # # # # # ### # # # ## ##    # # ## ## #  #
#              # # #  #  # #  #  # # #  ### #  # #
# # #############   ## # #  ## # # #  #  #    #  #
#  #           # # # # # # # #  #   #   # # # ## #
#### # ### # #           # #  #  # # ## #  ##  # #
#    #   #  #  ## # # ## # ## # ## #  #   #   #  #
## # # # # # #  ##   #  #            #  ## ##  # #
#### ## ###   ##  # #  #  # # # # # # # ## #  ## #
##    #  ## ##  # ## #   # ##  #  #         #    #
# # # # #     # #     ## # # # # #  # # # #  # # #
#    #  # ## #  # # ##  ##    #   #  #####  #  # #
# # # # #  # ## # ## # ## ## # ### ## # # ## # # #
##        #                                   # ##
# ######## ################################## # ##
#                                                #
##################################################
RRRRRRRRRRRRRRRRRRRRRRRRRRRRRRRRRRRRRRRRRRRROOLLLLLLLLLLLLLLLLLLLLLLLLLLLLLLLLLOOOLLLUUULLLLLLOOOOROOOOORRRRRRRRRRURRRRRRRRRROOOOOLLLLLLLLLLUULLLLLLLLLLLLLOOOOOOOOOOOOOOOOOOOOOOOOOOOOOOOOOOOORRRRRRRRRRRRUUUUUUUUUUUUUUUUUUUUUULLLLLUUUURRRRRRRRRRRRROOOOLOOOOOOOOOOOOOOOOOOOOOORRRRRRRRUUURRRRRRRRUUULLLLLUURRUUUUUUUUUUUUUUUUUUURUULLLLLLLLUUUUUUUUUUUURRRRRRRRRUURRRROOOOOOOOOOOOOOLOORRRORRRUUULLLUURRRRUUUUUUUUUUUURRROOOOOOOOOOOOOOOOOOOOOOOOOOOOOOOLLOOOOLLLLUUUUUUUULLOOOOOOOOOORROOORRRRUUURROOOOOO