########################################
#    #  #   #  ## ## ##  #  # #    # # #
# ## ##  # # #          # # # ## ##    #
##    ##       #### # # #          # # #
# ###    ### ##      ###  # # # ## ##  #
#     # #    #  ## #  # # #  ###     # #
# # ## # # #  #  # # ## #  #  ## # ##  #
####      #  #  #   #   # # ##    #  # #
# #  # # # # ## ## #### #    ### ###   #
#   # ## # #  #  ## # #   # #  #  # ## #
## #         #  # # #   # #  #   ##    #
#   ## # # #  # #    ###   #####   # # #
### ##  #### #    ###   # #  # # #  ## #
#  #   # #    # #    # #   #      ##   #
# #####   ## #  # # #    #  # ## #  ## #
# ##    #  # ###  ## # #  ## #     #   #
#   #### #      #     ## ##  # # # ### #
# ##       # # #  # ##   # # ##   #    #
#  ## # # #   # #  # # #       # # # # #
# # # ##   # ##   #     # ### #    # # #
# #  #  # #  # ##  # ### #     # ## #  #
# # #  # # # # #  # #  # ## ## #  # ## #
#    #          #   ##        ## #     #
# # #  # # #####  #   # ## # ##  # #####
#  #  ###      ##  # ### # ##  # #     #
# # ## # #### #   # # #      #   ##### #
#              ##       # ##  ##       #
########################################
RRRRRRRRRRRROOLLLOORROOOOOOOOOOOOOOOOOOORRORRRRRUULLLLUUUUUUUURRUUUUUUUUUUUUUURRRRRRORRROOOROORROOLLLLLOOOOOROOOOOOOOOORRRRRRRRRUULLUUUUUUUUUUUUUUUUUUUUURRRRRROOLLLLOORRRROOOOOOOOOOOOOOOOOOOOO