################################################################################################################################################################
#                           #   #   #    #    #  # #  #   #   #  #  #  #   ## #       #   # #                                         ## ##  ## ##             #
# # ## ## # # # # # ## # # # ## ## # ## # # ## # # # # # # ## ##  #  #  ##     # # # ####     # # # # # ### ## # ## # ## # ### # # ##       #     # ### ## ## ##
#  # # #  # ##   #   ## #                                        ## # # ### # # # #  ##   ## ###   # #  # # #   #    #   # #  # #    ## # # ### #     #  #  #  #
# #    ## ##   #  # #     # # ## # ## ## # # # ### # ###########      #  ###    # # #  ## # # # # #   #    ### ## # ### #    #    # ## #  ##   #  # #  # ###  ##
#  # #   #  # #  #   # # #  #   #  #  #  # ###   #  ##           ## ##  # #  #### #  # # #  # # # # #   ##  #  #  ####   # # # # # #    #    ##  ##  # #    # ##
# # # # #  # # #  # ###   #  # # # ##### ##    #  # #  ###### ##   # ##   ##      # #  # # #  #    #  #   #  #  #   #  # #  # ##    # #   ##   ##   # ### # #  #
#     ##  #  #   #   #  #  #  #       # # ## # ###  ##      #   # #    ##  ## # ##   #      #  ## # #  ##  #  #  # #  #   ##     # ###  #   ###   #    # # ### #
# # ## ##   ### #  #  #  #  #  # # ##       #     ##   # ## # #  #  # #  #     ##  ## ## ##  #    #  # ## # ## #  #  #  # #  ## ### #  #  #    # #  ##      #  #
#  ##     ## ### #  #  ## #  #  #    ## # ## # # #  # #   #  #  # #  # #   # ##  #  #  # #  #  ##   ###         # ##  #  #  #  ###    # #  # #  # #   ## # #  ##
# #  # ##     #    #  #     #  ### # #   #      # #    # #  # ##  # ## ## # # ## # # # ## # ####  #  ### ## # #  #   #  ###  #  # ## #    ### ##    ## # ## #  #
# ##     ## ## ## # # # # # ### #  #  # #  # ## # # # # # #      #                              # ### ###  # # ### # # # # ## #   ### ###  #    # #     #    ###
#    ## #   ##      ## #  #      ##  #   # # # #    # #     # # #  # # ## # # # # ## # # # # # #       # #        #  ##    ## ###  #  #   # # ## #  # ## # # # #
# ##   # # #   # # # #  # # # # ## # # # # # #   # #  # # #  # # #  ## #   #   #   # # # #  ## ## # ##     ## ##### #  ###      # # #  ##   #  # ## ##      #  #
#   ##    ####  #     #    #  #     #   #  #  # #   ## # #  #  #   #  ### # # #  #  ## # # #    # #  # # ##  #     # # #  ## ###    # ### #  #        # # #   ##
# ##  # ## #   # # # ### #  ## # # #  ## # # ##  # #      #   # ##   # # #     # # #   #### ## #  # #  #   #   ####     #    #   # #   #  # ### # # ##   # ### #
# # # ###  # #    #   #   #     #  ##    ## #   # # ## ##   ##     ### #  # # ## # # #   #   #  # ## #####   #     # # # # ## # # # # # #  ###   #     #       #
#        #  # # #  # #  ##  # ##  #   # #   #####   # #  ##   ## #       ###    #   # # # ##   #       # # ## # ## ##           # # # # # # #  #  # # # # #### #
# ## ## #  #   # ##   ##  # #   #  # # # # #     ## #   #   #   #  ## ### #  ##  # #  ##     #  # ####    #    #  #  # # # ## #              #  ##   #   #   ###
#  #   # # ## #   # ##  # # # # ## #     #  ## #  #  ##   #  # # # # ##     #  #  # #    # ### #     # # #  # #  #  # #  ## #### # # # # # #  ##  # # # #  #   #
# ### #  #      ##    #      #    #  ## # #  ## #  #   #### # ##       # # ### ## #   ##  #     # ## # #   ##   ###    ##     ## #  #  # #  #   # #       # # ##
#  # # # # ## # # # # # # # #  # #  ## ## ##     # ## #         ## ### # #  #   # ## #   #  ## #    #  # # # # ### ###    # #    # # #  #  #  ##    # # # # #  #
# #  #       # #   ## #  #   ##   ##   #     # #        # ## # ###   ## # ## # # #  # # # ## # ## ## ## #    ## #      # #   # #  #    # #  #   # #  # # #   # #
# # #  ## # ##   # # # #### #  # #   #   # ## # ## ## # ##    # #  ##   #      #   ##  #        #        ## # #  # # ## # ###  # # ## #    #  ## #  #      ## ##
#   ##   #     ## #  # # ##  #   # # # ##  #         #   # # #  ## # # # # ###   ##   # # # ## #  ## ### # #   # #####        #     ## ### ##  #  #  # ###     #
# ##   ## # # #    #   #   ## ##  # #   # ## # # ## #  ## #    #              ##   ## #  #   # ##   #  #   # #     #   # # # # # ##    # ##   # # # #     # ## #
# ## #     # # # # ## #  # #   # #   # #  # #   ####  ###  # #  ## ## # ######  # #     #  ##   # ## # ## # ## ## #  ## # # ## # # # ##    # #        ## #    ##
#     # # #  #  #   #  #  ## # # # #  #  ##   # ###  # # # #  # #  # #         # #### ### #  # ##  #    ##      ## ##   #           # # # # #  ## # #   # # #  #
# ## # # #  #  # # #  #  #   #  # # #  # #  # ## # ##        # # # #  # # # # #   #      # #   #  # # ## ## # #  #   ##  ### # # ## #   # # # #  #   # #  #  # #
# # #      ### #     #  #  #  # # # # # # #  #       # # # #         ## # ## ## ## # ## #   ## ##            # ##  ##   #    ###   #  ## ## ## # ## #  # ## ## #
#   # ### # #    ## #  # #  # ##  #     #  # ### ###    #  # # # # # # #         #  #   # #     # # # ## # ##    # #  #   # #    ## # #             # #    #  ##
# #      ## ## ### #  #  # # #  #  ## #  #  #  # # # # # ###  ##  #    # # ## ## # # ##    # # #  # # # # ##  # #  # #  #  #  ##       # # # # # ##  ## # #  ###
# ## ## #    # #     ###       #  #  # #   ## ###  # ##      #   # # #  #    #     #  # # #  #  # # #        # ### # # ### # #   # ## # ## #  #  #  #    ###  ##
#  # # #### #   # ##  #  # ## # #   #   ##     #  ###  ## # ####   #  #  # #  # ## ##  #   ##  #   # # # # #   ##   #   # ### ##  # ###   # ##  ###   ##  #  # #
# ####  #    ##    ### ##   # #   # # #    ## #  # # #   #   #   # # #  #  ##### ## # ### ## #  # #   #  ##  #    ## # #   #   # #      ##    # ##  #  # # #   #
#  #   ## # # ## #   #    ## ### ### #  # #     ##     # ## ## # #  # ##  #   ##    # ####     #    # ##   ##  # #    #  # # #     # ###  # # ##  # ###  #   # #
# ### #  #  #  # ### # ## ##  #   #   #  #  ### #  # #  #   #  ## # # # # ## #  ###    ## # ##  # #  # # ## ## #  ###  ##   # ## #  #  # # ##   #      #   # ###
#  #   #  # # #     ###      #  ## # ###  ##     ## #  #  ## ##    #     #     ##   # #   ## # #   #    #    # # #  ## # ##   ##  #  # #     # # ## ## # # #   #
# # # # # # # # ## # # ## # # #      ## ## ## ## #   # # # #  # # # # # #  # # # # # #  #    #  # # # #   # # #   #        ##    #  #   ## # #   #    #  ## ## #
#                 #    #   #  # ## ##        # #  ##    ##   # #    # #  ##   #    # # # # #   #     # ##  #  ## ### # # # #  ##  ##  # # #    ## # ## #      ##
# ## # # ## # # #  ## # # #  ##  ##  # ## # #   # #### #  # #   # #  # #   # ## ## #  #  #  ##  # ##     ## #   # # # ###   ##   #  #  #  ####  #       # ## # #
#  # #  # # ###  #         # #  # # ### ##    #    #    #    ##  #  #  # #     # #   # #  ##   #   ## ### # # # # #    # # # # #   #  ###    # # ## #####   #  #
## # # #       ##  ## ## ##  # #     #   # # ## # # # ## ## # # # # # # # # #### ### # # #  ##  # # #          #   ###     #   # ## #  # ###      # #    # # # #
## #  # # ## # # #   #  #   #    # ## # # ###  #                                           # # #    ## # # # #### ##   # #  ## #    # #  #  ## ###    # # ##   #
#   #    #  ###    ##  # # #  # # ###      ###  ### ## # # # # # # # # # ## # # # # ## # ###    # #   # # # #  #    ##### # # ## # #    #  # # # ## ## #  #  ###
## #  # # #  # # # # # #     #     # # # #  #  ## # #   # #  # # # # # #  ##  #  ## # #     ## #  # #         #  ##    #         ## # ##  #              ###   #
# #  # #    #   #      ## ##### # #  # ##  # #      ## ##   #   #   ##  #   #  # # #  ## ###   ##  #  #### # ## #  # # # ## ## #    #    ## ####### ## #  # # ##
#  # #  # # # #  # ####      ### # #  #  #     ## #   #  ##  # ## ###  #  #  # #    #       ##  # ###     #    ### ##    # # ### ###  ## #        #   # #      #
##  ###  ##  # #      # # # # #     #  #  # # #  #  #   #   ##   #    #  #  # #  # # # # # #   #   #  # #  # # ##    # ##  #        # #  # ## # # # ##   # ## ##
# #  # #    #  # # ###  ##  # # ## #  # #    #  # # # #  ##   # # # #  #  #    #  #   #  ##  #  # # #  ### ####   ##   #  # # ## # ##  #  #    #  ## # ## # #  #
#  # #  # ## #  #    ##   # #     #  #   ## # #     ### #   # ##  # # ### # ## # # ##  #   # # #     # ####  #  # #  #  # #   ##  #   ## ## # ###            # #
## #  #    #   # # #    ## ### ###  # # # ##   ## #    #### #  ## #### #   #  # ##   # # ## ## ## # # # ##  ## ###  ## #    ##   #### #    #   ## # # # # ## # #
#  # ## ### # ## # ## # #   #  #   #    #  # ##  #  ### # #  #  #   #    # # #    # ##      #   #  #       #  # ## #    # #  # #  #   ## #### #    ###  #  # # #
##                  ##    #  #  ## ## #   #    #  #   #    ## #   ## ## # #   # #      # ##  # #  #  # ### # ##   # #### ## ###  # ##  #   #  ### # # ## ####  #
#  ## ## ## ## ## #  ## # # # #     ##  #  # #  # # #   ##  #   # #   #     ####### # #    # #  # # #     #    ## #        # ###   #  #  #  ##  # #        # # #
## ##   #    # #   #   #   #  ### ##  #  #  # # #   ####   # ## # # #   ## ## # #  ##  # ## #  #  # ##### # # #    ## # ## #  #  # ## ##  #   #     # ### #    #
#    ## # # #  # #  # ## ## #   # ###  #  ##  #   #     ###   # # ##  # #  #  #  # # # #    ##  #        ##  # ### # ## #  # # #  #    # # # # ## ##  #  # # # #
## ##  #  #  #  # # #   # #  # #   # #   #   # ###  # #     ##   # # #  ###  #  ##    #  ##  # #  # # ##    #            #     # # ## #     #       ##  #   ####
## # # ## ##  # #    # ##  #   # ##   ##  ##   #  # ### ## #  ###   # ##  ##  #    # # # # ##   #  # # # ##  # ## # # # # ## #         # ## ##### #  # # # # # #
#       #   #  #  # #  #  # # ## ## ## # # # ## # #    # # # ##  # #   # # # # # # ##  # # # # #  #    #   #  #  # # # #  # # # ## ## #    #       ##    # #   #
## ### # # #  ### # ##  #                           # #   #     ##   ##  #      #    #   #   # ##   # #  ## #  # # # # ##       #   #  # ## # ### #   ##     # #
#    # # # ##  #  #  # # ## # ## # ### # # ## # # # #   #  # ##   ## #  ##### # # # ####   ##   # ## # # #   # #          # # #  #### #     # #     #   # # #  #
## ##     #  #  #  #  #  # #  #  #   ##  #  # # #  #  #  # # #  ## #  #  #   #   #   #   #   # #        #  ## #  # # ## ##  # # #     ## ##  ## # ## # # # # ###
##  ## # #  # #### # # #     # #  ##   #  # #  #  # ## #  #   #  # ##   # ## ## # # ####  # #   # # # ## #    # #   #     #  ##  ## ##    # #  #   # ### #     #
#  #    # # # # # #  #  # # #    # # #  # # # ### #    ##  # #  #     #              #   # # # #   #       ### # # # ## #  #   # # #   # # ###  # ##       ## ##
##  # #           # # #   # ## #   # # # #  #  #   # #   ## # #  ## ##  ## # # # # #  ##   #    # ## ### ##  #   ###    ### ## ###  # ##    ### #    ## ##   # #
## ##  # # # # ### #    #  #  #  #  #     #  ## # # #  # #      #  #  #   #  #  #   #### ##  # #  # #   # # #  ##    # #          #  #   ### #    # # #  ##### #
#  # ##  # ##    #  ###  ##  # # ## ### # ## #  # #  # # # # # # # ## # # # ## # # #  #    ###  #   # ##    # #### ### ## # # # # # # ## # #  # # #    ##      #
##     ##   ## #  #     #   ## #   #   #    # #  # #  #   ###  # #       #  #  #   # # # ##    #  ##     ##    ## #     #  #   ###           # #   ## ##  ## # #
#  # # # ### ## # ## ##  ##      ##  # ### #   # # # # # # # #     # # #  #### # #        ## #  #    ## # # ##     # # #  #  ## ### ## # # # #  # #  #  #  #  ##
##  #  #   #    ##     ###  # ##    #     #  #                 ## ###   #   # #   # ## ##   #  #  # ##     #  # #####   ##  #    # #  #  #  ###     #  #  # #  #
#  # #  # #  # # ## # #    ## #  # # ## ## ##  ## # ## # # ## #    ## # # ##  # ##  ##  # #  # ## ### ###### ###   #  ## ### ## #    # #  ## #  # #  #  ##  # ##
##    ##   #  ##     # ## #  ### ##   ##      # ##  ##  #    # ## #   # #    #   ##   #  ## #   #             #  # # #           ## #    ###  # #  ## #   # #  #
#  ##    #   #  ## # #  ## #  #     #  # #### #   #   ## # #   ###  #  #  # # # # # ## #   # # ## ### ## ## ##  # # ## # ### # #      ##  # #  #  # #   # #   ##
## #  ## # #   #  ### #  #   # # ### ####   #####   #  #   # #  #  #  ###  #    #   #    # #   #     ### #     #  #   # #    # ## ## # # #  ##  #   # ## #  ####
##  ## #  # ## # # #  # #  #   #     # ## #   #  ## ##  # # # ##  ## #####  ## #  # ## #  # ## ## # # #  ## ##  # # ##    ##  #  #  #     #   #   # # #   #   ##
#  # # # #   ##      #  # ####   # ##    #  #  #      ##        ##   ##### #   ## #   #  #         #    # #   #       # #  ## ##   #  ## #  ##  # ### ## #  #  #
##      # ##  # ## # # # # #   #  #  # # ##  ## # # ## #### ## #   #  ###   ##  # # ####  # # # # #  ##   # ##  # ## # # ##  #   ## # #    #   #           #  ##
#  # # #  #  # #    ## # #  ###  # #    #   #     #        ### # # ##  # # #  ##   #  # # # # # ## ##  # # #  ##  # #     # #  #       # #  ###  # ### # # # # #
##  #  # ### #  ## #   #   ##  #   ## #  # #  # ##  # ## ## #  ## #  #   #   #   #   #    #  #        # ##   #  ##  # # #     # ## # ##  # #   #  #  # # ## #  #
#  # ##   #  # #    # #  ##  # # ##    ##   ## # ## ##  #    #     #   ##  # # ##  #  # #  #  # ## # #    ##  #  # # ###  ## #     #  # #  # ## ## # ###      ##
## # # # ## ## #### # # # ## # #    ##    # #          #  ##  ## ##  ##  # ## # ##  #  #  # ##    #   # # #  #  ##    #  #  # # # #  # # #               # ### #
#                                # # # ##  #  ## ## ##   # ##   #  # # # #  #    # ####  #    # ## ## #  #  ###   # #  ## #     #  # #     # ## ## # # # #     #
# # # # # ## # # # # ## # ## # # #    ## #  # # ##  # ##    # ##  # #    # #  ###  ##  #  ## #     # #  #  # # # ## # #    # ##  # # # # #  #  #   #  # # # # ##
###  # ##   #  # # # #  ##   # #  # ###  # # #    #   ### # # # #     # ### #   # #  #  ##   ## # #    ## ## # #   #   # # # #  # #  #  #  # #   ##  #     #   #
#   ##    #  #  ## # ##   ## # ##  ##  #  ##   ##   ## # # # #   # ##  ###  # # ##  # #    ##  #   # #    #  #   ##  ##   ### ##    #  #  ##   #   #   ## ## # #
# ##   # ## # #   # #   #   #   # #  # # #  ###   # #      #   # ##  #  #  #   #  # # # # #  #  ##  #####  #  ##   # #  ## ##   # ## #  #   # ## ##  #  #   #  #
#  # #  ##    ## #  # #  # ### # # #   #  # #   # # # ## # # #  #   # #   #  # # ##    ## # # #  # # #   #  #    # #   ##     #  #     # # # #   #  # #  ##  # #
# #   # # # ##   # #   # ## ## #   # # # #  ######      ### #  ####    ##  ##  #   ## ##    #   # #   # # #  # #  #  ##  # # # ## ## ##      #### # # ##  #### #
# # ##     ##  # #  ##  # #   ####  #      #    # # # # ##   #  #  ## #   #   #  ## # # # ##  # # # #     # # #  ###   #   # #  # # #   ## ##           #     ##
# # ### # #  #  # #   # # # #  # # # # ## ## ##      ###  # ###  #  #  ##   ## #  #       #  # #  #### # #      # # # # # # #  #    ## #   # ### ### # ## ## # #
# ## #   #  #  #   # # #   # #   #   #  # # ### # # ###  #   #  # #   ### # #    # # ## #  #    #   # #   # ## #  # #   # # # ## ### ##  # #       # #   # #   #
## # # #  #  ## ##      # #   ## # # # # #   #   #   #  # # #  #   ##  #   # # #    # #  #  # #   ##   # #    #  #  # ##  #   #  #    ##  #  # # # #  # #    # #
#     # ##  ##  #  ## ##  ## #   # # #   ## ### ### ## ## # # # # ## # ## ## ## ## ## # # ## # # # ### # ## ## # ## # ### # ## # # # #   ### #  # #  #   # #  ##
# ## ##   #   #  # #  #  #    ## #  #  ##   ###  #                                                                     #            ## #  ###  #   #  ##  # #  #
###  #  ## # ### ## # # # ## # # ## # # ## # # ## ################################################################### # # ###### # #  # ## # #  ##  #  # ##   ##
#  # # #   #  #                                                                                                         # #     ##   #        #    # #  #  ## ##
##   # # #   #  ## ## # ## ## ## # # # # ## # # ## ## # # # # # ### ## ## # # # # ## ## # # # # # # # # # # # # ## ## #    # # #  # # ## ## ### # ## # ## # ## #
#  #    # ##  #  # #  # # ### #  # #  # #   # #  # #   #   #  #   # #  # #   # #  #    #  #  #   #   #  #  #  # #  #   # # #  #  ####    # ##    #             #
# # ## #    #   # ## #     #   # #### #  ## #  ### # #####  #  # ##  ##    # #  #  # # # #  ## #  # # # ##  # #  #  # #  #   # #  #   ###    # #  # ## # # # # #
##   # ## #  ##   #   # ## ## #    # # #  #  ##   ###  #  #  ####  ###  ## ##  ### #  # # #   ## #    #  # #   ## #  ### # #     # # ## # ## # # # #    #   # ##
# # #    #  #  # # ### #  # #  # ##      # # # # # # # ##  ##  #  #   ##  #  #  # # ###    ###  # ####  # ## ###   #  # #  # # #           # #  #    # #  #    #
# # ## ## # ## # #     # #   #  #   # # ##  #    # # #  # #  #   #  # #  #  # # # # #  # #    # # #  ####   #    # # #  # ## # ######### ## # #### # #  # # # ##
#                 # # #   # ##### # # # # # ### ## # # ## # # # ## # # # ## # # # # # # # # # #   # #    # #  # #   # #     #          ## #     ## ## #  #   # #
## # # ## # # ## # #  ## ##  #   #   #                                                       ## ##   ## #   ##  ###   # # # # ## ## ##      # ##       # # # # #
# ## ### # # # ### # # # # # ### ## ## # # # ## # # ## # ## # ### # # # # ## ## ### ## ## # ##    # ### # ## # #  # ## # # # #  ## # ## ## #    ## #### #  ##  #
#                                     ##  #  #  #  #  # ## # ## ## # # # # ## ### ## ## ###   ## #   #  #  #  #  #  #  #     # #       #    # # #        #    ##
## ## # ## ## # ### # ## ### ## # # # #  #  ## #  #  #                                      # #   # # # # # # # #  #  # ## ##    ## # # # # #  # # # # #  # ## #
# #   ##   # ###   # #  ## # #  # ## ### # #  #  # #   ##################################### # # ## # # # # # # ## ## # #     # ## # #   ###  ##   #  #  #     #
#  # #  ###   #  ##   # #  #  ####    ### # #  ##    #                                                                    ## #         ## # #   # #  # # # # # #
## ## # # # ## # # # ## ## #### # ## # ## # # # ##### ################################################################### # # ## # ###       # ##  #    ##  #  #
#                                                                                                                               #     # # ##  #   #  # #   ### #
################################################################################################################################################################
