##########
#  # #   #
##     # #
#  # # # #
# # ###  #
#    # # #
# # #    #
#  #  ## #
##  ##   #
# #   ## #
# ## ##  #
#      # #
##########
