########################################
#    #  #  #  #  # #  # #  #     # ##  #
# ##  # # # # # ## # ## ##  ## # #   # #
##  #                    # #  #   ##   #
# #   # # # # ## ## # ##    #   ##  ## #
#   # #  # #   # #   #   ### ## #  #   #
# ##  ####  ### ### #  # # #  #   # ## #
## ##     #   #  #  ###      #  #   #  #
#     # #  # #  # #    # ### # ## #  # #
### # # ##     #   # #  #    # #   # # #
#  # # # ## ##  # # #  # # # #  # # #  #
##         # # #  #  # #  ## # #  #   ##
#  ### # #     ##  # ##  #   #  #  # # #
##    # #  ####   #     # ## # #  #    #
#  ## # ####    #   # ##   # # # ## ## #
## #         ## ### # #  ##    # # #   #
# # #########  #  #  ###    # #     ## #
#             ## #  # # # # #  # ## #  #
# # ## ## # #     #      #   #  #    # #
# ### ##   # # # # ##### # ## #  # #   #
#       ##    #           #     #   ## #
########################################
