################################################################################
#  #  #  # # # ###   # #    #   ## #  #      #   # ##### ##  ##   ##        ## #
# ## # #        # ##    ## # ##      # # ## ## # #  ###    #    #    ### ##    #
#       # # ## #  # # #  # # # # # ##     # #  ##  # # # #### ## # ##    # # # #
# # # #  # ##   # #  #  #  # #    # # # #  #  #  # # #     #   #  # # # #  # # #
## # # #      #   ##   # #   # # #  #  # # # ## #  #  # ##  # #  #  #  ## # #  #
#  #    ## # ## ##  ## #   ## ##  #  ##    # #   # # # #   # # #   # ##       ##
##  # # # ###    # ##   # #      #  #  # ##   # ## #    # #  #  ##      # # #  #
#  # #     # ## ## # ##    # # #  #  #    # # # #   ## ## ## # #  # # # # ##  ##
## #  ## ##        # ## # ##  # #   # ## ##  ##  # # #     #   ##  # # # # ##  #
#    #     # ### ##    #    ##    # # #    # #  #  # ## ##   ##  #   #        ##
# ##  # # # ## #   ## # # ##   ## ##  # ## #  #  # #  ##  # ####  # # # # # #  #
##  #  ## #     ##  #   #   # # #    #    #  ## #    # # #   ##  ##    #  # # ##
#  # # #   # ## # #   # # ## #   ## ### # ## #   # #      # #   #  # #  ## #   #
# #    # #  ###    ##  #  #   ##  #  #   # # # ## #  ## ##   ##   #   # #   # ##
#  # #  #  ### ## # ## # # # ## # # # # ## # # #  ##   ## # # # ## # # # # #   #
# # # #   # #                                    #   ##                    ## ##
#      ## #  # ## ## ## # ############## ###### # ##   # # # # ## # # ## #     #
# # ##    ## ##    #  # # #             #         ## ## ## #  #  ## #   #  # # #
## #  # #      ## # ## # # # # # # # ### ## # # ##          # ## # ### # ##  # #
##   # ## # ##               # #  #  # # ##  #  ## ######### # # # ## ##   ##  #
# ##      ##  ### ## # # # # # # # # #      # ##                         ### # #
#   # # ##   #    #  #  ## # #  #    # ## #     ## ## # # ## ## ## # ## ##   # #
# # # ##   #   ## ##  # # ###  ## ## # # # # # ###  # #  #  # # ## # ## #  ##  #
##      # # # #    # ###   # # #  #  # # # ## # # ## # ####    #  # #     #   ##
#  # # # #     # #  # ####    # ## # #                   # # ## # # ### #  ## ##
###   #   ### # # #    #  # ##   #   ## # ## # # ## ## #                # #  # #
#   ### ##    #     # ### #  # #   #   #   ##  ##    #  # ### # # ## ##  # # # #
# ##       # # # # ##  ## # # # # #  # # #  ##   ## # # # #    #  # #   #      #
# #  ## # ## #  #    ##       # #  #  ### #  # # # #     #  ##  ##    #   # # ##
#### ###    # #  # ##  ## ## #   ##  # ##  ##  #   ### #  # #  ## # #  # #  ## #
# # # ## # #   # #  # #   #  # ##  # #    #  #  ##   # # ###  #     # #   #    #
#         # # #   ##   ### # # # # #   # #  # #  # # # #  # #  ## # #  # #  # ##
## ## # # #     #    #               #  #  #    ### #  # #  # #  #  # ## # #  ##
##  #  # # #### # ###### # # # # ## #  #  #  ##  #  ### ### ## # # #    ## ### #
#  #  #    #   # #   #  # ## ## # #  #  # # #  #  #      #          ## #       #
## # #  ##   #    ##  #            ## #    #  # ##  ## # # ## ## # #   ## # # ##
# # #  # # # # # #  # ## # # # # #    # # # #     #   # #### #  #   ##  ###  ###
# #   ##  # # ## ##     #   #   #  ###  # #  # ## # # # ##     ## #   #    #  ##
#  # #  #           ## #  ### # ## #  # #  # #   #  # #   # ##   # # #  # ###  #
# # # #   ## ##### #  # ##     #     ##  ##   # ###  # # ##  # #    ###  # # # #
# #    # ## #        ##  # ## #  # #   ##### #  ##  #      ## #  # # # ##    ###
#   ##   #   # # # #   #  # # # #  ## #  ###  #   # # # # #    #  #      ## #  #
# # ### #  #  # #   # #  ##  # # #   # #  #  #  # #   ##  ### #  #  # # ##  # ##
#### ###  # #    # # ## ## # # # # ### # ## # # ## # # # #  #  #   #   #   #   #
# #   # # # ## #                 #                      #  #  ### # # ### ## ###
# # ##   #   ## # ## ## ## # # #  # ########## # # ## #  #  #  #  #  ###       #
# # #  # # ## #   #    # # # ### # #          # #  # #  # # # # # # # # # # # ##
# #  # #    #  ## ## ##     #        ## # ###    # #  #                    # # #
# # #   ## # #     #   # ##  # # ## #   # #   ## ##  #  # # # ## # # # ## ##   #
# #  # #       ## # ###   ## #  #    ## #  # ###  ## ### # # # ## # ## # #  # ##
# ##  # ### # # #      ##  # # #  # # # # #  ##  #                        # #  #
#  ## #     ##    ### ##  # #   ##     #  # #  # # # ## ## # ## # # # # #     ##
# #     ####   ## # #   # # ## #   ## # # #  #   # # #   # # #   #  # #  ## ####
# # ####    # # #   # # # #     # ##     # ##  #  #   # #   #  # ##  #  #     ##
#  #    # #  #  # ## ##  # ## # # # ## # #    #  # # # #  #  # #  # ### # # #  #
## ## # ## # ##        ##  #   #  #     ### ## # # #   # #  #  ##  # # ##  #  ##
#   # #    #    ## # #    # # # #  # ##  ### #     # #  # # # #   #       # #  #
# #  # ### # ##   ### # # # #   ## # #  # ##   # # #  #    #  # ## # # # #    ##
## #     #  #   ## #   #    # #   #   # #   # #### # ## # #  #      # #   ## # #
#    # #   # ## #    #  # #  # ###  ##   # #  ##   #   #   ##  ## # #  # # #   #
### # #  #        # #  # # # #    # # # ##  ##   # # #####   ### # # # ##    # #
#   #  #  # ### ##### ##    #  # # #   ##  #   ##  #   #  # #    #   #   ### ###
# #  # # # #    # #  #   # #  ## #  ##   #  # #  # # #   ### # #  ##   ##      #
# # #    #   ##     # ## #  # #    #  ## # #  ## # #  # # #   #  # # #   ## # ##
##   ## ### #   # # # #   #### # #   ##     ##     # # #  # # ##     ## #    # #
#  ##  # # # ## ##### # #   #   #  # #  # ##  ####   # # #   #   # #   #### #  #
# #  #   #    #   #    #  ## # # #  # #  #  # #   # #     # # # ### # # #  #  ##
## #   #  ###   ## # ## # ## # # # ## # # # # ## # # # #### # # ##  ##   #  #  #
#   ##  #     #                                                    # # ## #   ##
## # # # # # #  # ####################### ## # # # # # # # # # # ##        # ###
#  #  #    #  #  #                       #   # #  #  #  ###   #     ## # #   ###
##   ### #  # # # # # # ## # # # # # ###  # #   #  # # ### ### # ### # #  # # ##
### # ###  # # #  ### # ##  #  # ##  #   # # # ## #  #  #        #    #### #   #
##  #  # ###    #     #   #  # #  # # ##     # #  ###  # # ###### # #  #    # ##
#  # #   #   # # ## #  # # # # ## ##   # # ## #  #   ##  #          # # ## ##  #
##   ###  # ##    ##  #    #  # ##   #    ###  ## # # ## ###### ## #  #  #   # #
### #  # # #   # #  # # # #  #    # ## # # # #                  # ### # # # ## #
##   #      ## ## # # # # # # # ##  # ##   #   # # # ## ## ## ##   ###  # # #  #
# ## # # ##            # # #  #   ##     ## # # # # # ### ## # # ## # # # #  # #
#    ####   # ## ## # #    # # ## #  ###    #                              # # #
# ##   # # ##   ### #   ## #        #    ## # # # ### # ### # ## ## # ### #  # #
##  # ##  #   ## # #  # #   # # ### ## #  #  ###  #  ###   ##   ## #     ###   #
# #      # ##      ###   # #  ##   #  ## # ## # ## # ## # ## ###    # # # # ## #
# # # # #  # # # #    # #   ##   # # #                           # #  ##       #
#  # #  # ## #  #  ##  # # #  ###      # # ## # # # # ## # # ## #   #    ## ## #
## # ## # #    #  # ## # #  #     ### # #   ##   ## #   #  # #  ## # #### ## # #
#           # #  #       # #  ## #      # ##   #   ### #  #   ##               #
################################################################################
